border_size=1
usage=map

Urb         , Urb         , Urb         , Urb         , Xos         , Rb          , Xos         , Urb         , Urb         , Urb         , Urb         , Xos         , Xos         , Rrc         , Rrc         , Rrc         , Rrc         , Rrc         , Rrc         , Xos         , Xos         , Re          , Re          , Xos         , Xos         , Urb         , Urb         , Urb         , Xos         , Re          , Xos         , Urb         , Urb         , Urb         , Xos         , Xos         , Re          , Re          
Urb         , Urb         , Xos         , Xos         , Xos         , Rb          , Xos         , Urb         , Urb         , Urb         , Urb         , Xos         , Urb         , Xos         , Xos         , Rrc         , Rrc         , Rrc         , Rrc         , Rrc         , Rrc         , Xos         , Xos         , Re          , Re          , Xos         , Xos         , Urb         , Xos         , Re          , Xos         , Urb         , Xos         , Urb         , Re          , Re          , Xos         , Xos         
Xos         , Xos         , Urb         , Urb         , Xos         , Rb          , Xos         , Urb         , Urb         , Urb         , Urb         , Xos         , Urb         , Urb         , Urb         , Xos         , Xos         , Rrc         , Rrc         , Rrc         , Rrc         , Rrc         , Rrc         , Xos         , Xos         , Re          , Re          , Xos         , Xos         , Re          , Xos         , Xos         , Re          , Re          , Xos         , Xos         , Urb         , Urb         
Xos         , Urb         , Urb         , Urb         , Urb         , Rb          , Rb          , Xos         , Xos         , Urb         , Urb         , Xos         , Urb         , Urb         , Xos         , Urb         , Re          , Xos         , Xos         , Rrc         , Rrc         , Rrc         , Rrc         , Rrc         , Rrc         , Xos         , Xos         , Re          , Re          , Re          , Re          , Re          , Xos         , Xos         , Urb         , Urb         , Urb         , Urb         
Xos         , Urb         , Urb         , Urb         , Xos         , Xos         , Xos         , Rb          , Rb          , Xos         , Xos         , Xos         , Xos         , Xos         , Re          , Re          , Xos         , Xos         , Urb         , Xos         , Xos         , Rrc         , Rrc         , Rrc         , Rrc         , Rrc         , Rrc         , Re^Es       , Re^Es       , Re^Es       , Re          , Xos         , Re          , Urb         , Urb         , Urb         , Urb         , Urb         
Rrc         , Xos         , Xos         , Xos         , Urb         , Urb         , Urb         , Xos         , Xos         , Rb          , Rb          , Xos         , Re          , Re          , Xos         , Urb         , Urb         , Urb         , Urb         , Urb         , Xos         , Xos         , Rrc         , Rrc         , Rrc         , Rrc         , Rrc         , Rrc         , Xos         , Xos         , Xos         , Re          , Re          , Xos         , Xos         , Urb         , Urb         , Urb         
Rrc         , Rrc         , Rrc         , Xos         , Xos         , Urb         , Urb         , Urb         , Urb         , Urb         , Xos         , Rb          , Rb          , Xos         , Xos         , Urb         , Urb         , Urb         , Xos         , Xos         , Rrc         , Rrc         , Rrc         , Rrc         , Rrc         , Rrc         , Xos         , Xos         , Urb         , Urb         , Urb         , Xos         , Xos         , Re          , Re          , Xos         , Xos         , Urb         
Xos         , Rrc         , Rrc         , Rrc         , Rrc         , Xos         , Xos         , Urb         , Xos         , Xos         , Urb         , Xos         , Urb         , Rb          , Rb          , Xos         , Xos         , Xos         , Rrc         , Rrc         , Rrc         , Rrc         , Rrc         , Rrc         , Xos         , Xos         , Urb         , Urb         , Urb         , Urb         , Urb         , Urb         , Urb         , Xos         , Xos         , Re          , Re          , Xos         
Urb         , Xos         , Xos         , Rrc         , Rrc         , Rrc         , Rrc         , Xos         , Xos         , Urb         , Urb         , Urb         , Urb         , Xos         , Xos         , Rb          , Rrc         , Rrc         , Rrc         , Rrc         , Rrc         , Rrc         , Xos         , Xos         , Urb         , Urb         , Urb         , Urb         , Urb         , Urb         , Urb         , Urb         , Urb         , Urb         , Urb         , Xos         , Xos         , Re          
Urb         , Urb         , Urb         , Xos         , Xos         , Rrc         , Rrc         , Rrc         , Rrc         , Xos         , Xos         , Xos         , Xos         , Urb         , Urb         , Xos         , Xos         , Rrc         , Rrc         , Rrc         , Rrc         , Xos         , Urb         , Urb         , Urb         , Urb         , Urb         , Urb         , Urb         , Urb         , Urb         , Urb         , Urb         , Urb         , Urb         , Urb         , Xos         , Xos         
Urb         , Urb         , Urb         , Urb         , Xos         , Xos         , Xos         , Rrc         , Rrc         , Rrc         , Rrc         , Rrc         , Rrc         , Xos         , Xos         , Urb         , Urb         , Xos         , Xos         , Rrc         , Rrc         , Rrc         , Re          , Xos         , Xos         , Urb         , Urb         , Urb         , Urb         , Urb         , Urb         , Urb         , Urb         , Urb         , Xos         , Xos         , Re^Em       , Re          
Urb         , Urb         , Urb         , Xos         , Urb         , Urb         , Xos         , Rrc         , Rrc         , Rrc         , Rrc         , Rrc         , Rrc         , Rrc         , Rrc         , Xos         , Xos         , Xos         , Rrc         , Rrc         , Rrc         , Rrc         , Xos         , Re          , 2 Re        , Xos         , Xos         , Urb         , Urb         , Urb         , Urb         , Urb         , Xos         , Xos         , Re          , Re          , Xos         , Xos         
Xos         , Xos         , Urb         , Xos         , Urb         , Urb         , Xos         , Rrc         , Rrc         , Rrc         , Gg          , Gg          , Gg          , Rrc         , Rrc         , Rrc         , Rrc         , Rrc         , Rrc         , Rrc         , Xos         , Xos         , Urb         , Xos         , Xos         , Re          , Re          , Xos         , Xos         , Urb         , Xos         , Xos         , Re          , Re          , Xos         , Xos         , Urb         , Urb         
Xos         , Urb         , Urb         , Xos         , Urb         , Urb         , Xos         , Rrc         , Rrc         , Gg          , Ww^Ewl      , Ww          , Ww^Ewf      , Gg          , Gg          , Rrc         , Rrc         , Rrc         , Xos         , Xos         , Urb         , Urb         , Urb         , Urb         , Xos         , Xos         , Xos         , Re          , Re          , Xos         , Rb^Em       , Re          , Xos         , Xos         , Urb         , Urb         , Urb         , Urb         
Xos         , Urb         , Urb         , Urb         , Urb         , Urb         , Xos         , Rrc         , Rrc         , Gg          , Ww^Ewf      , Ww^Ewl      , Ww^Ewl      , Ww          , Gg          , Rrc         , Rrc         , Xos         , Urb         , Urb         , Urb         , Urb         , Xos         , Xos         , Re^Emf      , Re^Emf      , Xos         , Xos         , Rb^Es       , Rb          , Xos         , Urb         , Urb         , Urb         , Urb         , Urb         , Urb         , Urb         
Xos         , Urb         , Urb         , Xos         , Xos         , Xos         , Rrc         , Rrc         , Rrc         , Gg          , Ww          , Wwg^Ewf     , Ww^Ewf      , Ww^Ewl      , Gg          , Rrc         , Rrc         , Xos         , Urb         , Urb         , Xos         , Urb         , Re^Es       , Re^Em       , Xos         , Xos         , Rb          , Rb          , Urb         , Xos         , Urb         , Urb         , Urb         , Urb         , Urb         , Urb         , Urb         , Urb         
Xos         , Urb         , Xos         , Xos         , Rrc         , Rrc         , Rrc         , Rrc         , Rrc         , Gg          , Gg          , Wwg^Ewf     , Ww^Ewl      , Ww          , Gg          , Rrc         , Rrc         , Xos         , Xos         , Xos         , Urb         , Xos         , Xos         , Re^Es       , Rb          , Rb          , Xos         , Xos         , Urb         , Xos         , Urb         , Urb         , Urb         , Urb         , Urb         , Urb         , Urb         , Urb         
Xos         , Xos         , Rrc         , Rrc         , Rrc         , Rrc         , Xos         , Rrc         , Rrc         , Rrc         , Rrc         , Gg          , Gg          , Ww          , Gg          , Rrc         , Rrc         , Xos         , Urb         , Urb         , Urb         , Urb         , Urb         , Xos         , Rb          , Xos         , Urb         , Urb         , Urb         , Xos         , Urb         , Urb         , Urb         , Urb         , Urb         , Urb         , Xos         , Xos         
Rrc         , Rrc         , Rrc         , Rrc         , Xos         , Xos         , Urb         , Xos         , Xos         , Rrc         , Rrc         , Rrc         , Rrc         , Gg          , Rrc         , Rrc         , Rrc         , Xos         , Xos         , Urb         , Urb         , Urb         , Urb         , Urb         , Rb          , Xos         , Xos         , Urb         , Urb         , Xos         , Urb         , Urb         , Urb         , Urb         , Xos         , Xos         , Rrc         , Rrc         
Rrc         , Rrc         , Rb          , Xos         , Xos         , Urb         , Urb         , Urb         , Urb         , Xos         , Xos         , Rrc         , Rrc         , Rrc         , Rrc         , Rrc         , Rrc         , Rrc         , Rrc         , Xos         , Xos         , Urb         , Xos         , Xos         , Urb         , Rb          , Rb          , Xos         , Xos         , Xos         , Urb         , Urb         , Xos         , Urb         , Rrc         , Rrc         , Rrc         , Rrc         
Rb          , Rb          , Xos         , Rb          , Rb          , Xos         , Urb         , Urb         , Urb         , Urb         , Xos         , Xos         , Xos         , Rrc         , Rrc         , Rrc         , Rrc         , Rrc         , Rrc         , Rrc         , Rrc         , Xos         , Urb         , Urb         , Urb         , Xos         , Xos         , Rb          , Rb          , Xos         , Xos         , Xos         , Rrc         , Rrc         , Rrc         , Rrc         , Gs          , Gs          
Xos         , Xos         , Xos         , Urb         , Xos         , Rb          , Rb          , Xos         , Xos         , Xos         , Urb         , Urb         , Urb         , Xos         , Xos         , Rrc         , Rrc         , Rrc         , Rrc         , Rrc         , Rrc         , Xos         , Urb         , Urb         , Urb         , Urb         , Xos         , Xos         , Rrc         , Rrc         , Rrc         , Rrc         , Rrc         , Rrc         , Gs          , Gs          , Gs          , Gs          
Urb         , Urb         , Xos         , Urb         , Urb         , Xos         , Xos         , Rb          , Rb          , Xos         , Xos         , Urb         , Urb         , Urb         , Urb         , Xos         , Xos         , Rrc         , Rrc         , Rrc         , Rrc         , Xos         , Xos         , Urb         , Xos         , Xos         , Rrc         , Rrc         , Rrc         , Rrc         , Rrc         , Rrc         , Rrc         , Gs          , Gs          , Gs          , Ds          , Gs          
Xos         , Xos         , Urb         , Urb         , Urb         , Xos         , Urb         , Xos         , Urb         , Rb          , Rb          , Xos         , Xos         , Urb         , Urb         , Urb         , Xos         , Xos         , Xos         , Rrc         , Rrc         , Rrc         , Rrc         , Xos         , Rrc         , Rrc         , Rrc         , Rrc         , Rrc         , Rrc         , Gs          , Gs          , Gs          , Rrc         , Rrc         , Ds          , Ds          , Ds          
Urb         , Xos         , Xos         , Urb         , Urb         , Xos         , Urb         , Urb         , Urb         , Xos         , Xos         , Rb          , Rb          , Urb         , Xos         , Xos         , Urb         , Urb         , Xos         , Rrc         , Rrc         , Rrc         , Rrc         , Rrc         , Rrc         , Rrc         , Rrc         , Rrc         , Rrc         , Rrc         , Gs          , Gs          , Ds          , Ds          , Ds          , Ds^Bw\      , Wwg^Bw\     , Wwg         
Urb         , Urb         , Urb         , Xos         , Xos         , Xos         , Urb         , Urb         , Xos         , Xos         , Rb          , Rb          , Xos         , Urb         , Xos         , Urb         , Urb         , Urb         , Xos         , Rrc         , Rrc         , 1 Rrc       , Rrc         , Rrc         , Rrc         , Rrc         , Rrc         , Rrc         , Rrc         , Rrc         , Gs          , Gs          , Ds          , Ds          , Wwg         , Wwg         , Wwg         , Wwg^Bw\     
Urb         , Urb         , Xos         , Xos         , Urb         , Xos         , Xos         , Xos         , Rb          , Rb          , Xos         , Xos         , Urb         , Urb         , Xos         , Urb         , Urb         , Urb         , Xos         , Rrc         , Rrc         , Rrc         , Rrc         , Rrc         , Rrc         , Rrc         , Rrc         , Rrc         , Rrc         , Rrc         , Rrc         , Ds          , Ds          , Wwg         , Wwg         , Wwg         , Wwg         , Wwg         
Xos         , Xos         , Urb         , Urb         , Urb         , Xos         , Rb^Em       , Rb          , Xos         , Xos         , Urb         , Urb         , Urb         , Urb         , Urb         , Urb         , Urb         , Urb         , Xos         , Rrc         , Rrc         , Rrc         , Rrc         , Rrc         , Rrc         , Rrc         , Rrc         , Rrc         , Gs          , Gs          , Ds          , Ds^Bw\      , Wwg^Bw\     , Wwg         , Wwg         , Wwg         , Wog         , Wog         
Urb         , Urb         , Urb         , Urb         , Urb         , Xos         , Rb^Em       , Rb          , Xos         , Urb         , Urb         , Urb         , Urb         , Urb         , Xos         , Urb         , Urb         , Urb         , Xos         , Rrc         , Rrc         , Rrc         , Rrc         , Rrc         , Rrc         , Rrc         , Rrc         , Gs          , Ds          , Ds          , Ds          , Wwg         , Wwg         , Wwg^Bw\     , Wwg^Bw\     , Wwg         , Wog         , Wog         
Urb         , Urb         , Urb         , Urb         , Xos         , Xos         , Rb          , Rb^Es       , Xos         , Urb         , Urb         , Urb         , Urb         , Urb         , Xos         , Urb         , Xos         , Urb         , Rrc         , Rrc         , Rrc         , Rrc         , Rrc         , Rrc         , Gs          , Gs          , Ds          , Ds^Bw\      , Wwg^Bw\     , Ds          , Wwg         , Wwg         , Wwg         , Wwg         , Wwg         , Wwg^Bw\     , Wog^Bw\     , Wog         
Xos         , Urb         , Xos         , Urb         , Rb          , Rb          , Xos         , Xos         , Xos         , Urb         , Urb         , Urb         , Urb         , Urb         , Xos         , Xos         , Rrc         , Rrc         , Rrc         , Rrc         , Rrc         , Rrc         , Rrc         , Gs          , Gs          , Ds          , Ds          , Wwg         , Wwg         , Wwg^Bw\     , Wwg^Bw\     , Wwg         , Wwg         , Wwg         , Wog         , Wog         , Wog         , Wog         
Xos         , Xos         , Rb          , Rb          , Urb         , Xos         , Urb         , Urb         , Xos         , Urb         , Urb         , Urb         , Xos         , Xos         , Rrc         , Rrc         , Rrc         , Rrc         , Xos         , Xos         , Gs          , Gs          , Gs          , Rrc         , Ds^Bw\      , Ds          , Wwg         , Wwg         , Wwg         , Wwg         , Wwg         , Wwg^Bw\     , Wwg^Bw\     , Wwg         , Wog         , Wog         , Wog         , Wog         
Rb          , Rb          , Xos         , Xos         , Urb         , Xos         , Urb         , Urb         , Urb         , Urb         , Xos         , Xos         , Rrc         , Rrc         , Rrc         , Rrc         , Xos         , Xos         , Urb         , Xos         , Gs          , Gs          , Gs          , Ds          , Ds          , Wwg^Bw\     , Wwg^Bw\     , Wwg         , Wwg         , Wwg         , Wwg         , Wwg         , Wog         , Wog^Bw\     , Wog         , Wog         , Wog         , Wog         
Xos         , Xos         , Urb         , Urb         , Urb         , Xos         , Urb         , Urb         , Xos         , Xos         , Rrc         , Rrc         , Rrc         , Rrc         , Xos         , Xos         , Urb         , Urb         , Urb         , Xos         , Gs          , Gs          , Ds          , Ds          , Wwg         , Wwg         , Wwg         , Wwg^Bw\     , Wog^Bw\     , Wog         , Wog         , Wog         , Wog         , Wog         , Wog         , Wog         , Wog         , Wog         
Xos         , Urb         , Urb         , Urb         , Urb         , Xos         , Xos         , Xos         , Rrc         , Rrc         , Rrc         , Rrc         , Xos         , Xos         , Urb         , Urb         , Urb         , Urb         , Urb         , Xos         , Gs          , Ds          , Ds          , Ds          , Wwg         , Wwg         , Wwg         , Wwg         , Wog         , Wog^Bw\     , Wog^Bw\     , Wog         , Wog         , Wog         , Wog         , Wog         , Wog         , Wog         
