border_size=1
usage=map

Hh          , Hh          , Hh          , Hh          , Hh          , Mm          , Mm          , Mm          , Mm          , Mm          , Mm          , Mm          , Mm          , Mm          , Mm          , Mm          , Mm          , Mm          , Hh          , Mm          , Mm          , Mm          , Mm          , Hh          , Hh          , Hh          , Hh          , Hh          , Wog         , Wog         
Hh          , Hh          , Hh          , Hh          , Gs^Ft       , Hh          , Hh          , Hh          , Hh          , Hh          , Hh          , Hh          , Hh          , Mm          , Hh          , Hh          , Hh          , Hh          , Hh          , Hh          , Hh          , Hh          , Hh          , Hh          , Gs^Ft       , Gs^Ft       , Gg          , Gg^Ft       , Wog         , Wog         
Hh          , Gs^Ft       , Gs^Ft       , Gs^Ft       , Gs^Ft       , Gs^Ft       , Gs^Ft       , Hh          , Gs^Ft       , Hh          , Gs^Ft       , Gs^Ft       , Gs^Ft       , Hh          , Gs^Edpp     , Hh          , Gs^Edpp     , Gs^Ft       , Gs^Vht      , Gs^Ft       , Gs^Edpp     , Gs^Vht      , Gs^Edpp     , Gs^Vht      , Gg          , Gg          , Wog         , Wog         , Gg          , Gg          
Gs^Ft       , Gs^Ft       , Gs^Ft       , Gs^Ft       , Gs^Ft       , Gs^Ft       , Gs^Ft       , Gs^Ft       , Gs^Ft       , Gs^Ft       , Gs          , Gs^Ft       , Gs^Edpp     , Gs^Edpp     , Gs^Edpp     , Gs^Edpp     , Gs^Edpp     , Gs^Edpp     , Gs^Edpp     , Gs^Edpp     , Gs^Vht      , Gs^Edpp     , Gg          , Gg          , Wog         , Wog         , Gg          , Gg          , Gs          , Gs          
Gs^Ft       , Gs^Ft       , Gs^Ft       , Gs^Ft       , Gs^Vht      , Gs^Vht      , Gs^Edpp     , Gs^Ft       , Gs          , Gs          , Gs^Edpp     , Gs^Edpp     , Gs^Edpp     , Gs^Edpp     , Hh          , Gs          , Hh          , Gs^Vht      , Gs          , Gs          , Gg          , Gg          , Wog         , Wog         , Gg          , Gg          , Ce          , Ce          , Ce          , Hh          
Gs^Ft       , Gs^Ft       , Gs^Edpp     , Gs^Edpp     , Gs^Edpp     , Gs^Edpp     , Gs          , Gs^Edpp     , Gs^Edpp     , Gs^Edpp     , Gs^Edpp     , Gs^Edpp     , Hh          , Hh          , Mm^Xm       , Hh          , Gs^Ft       , Hh          , Gg          , Gg          , Wog         , Wog         , Gg          , Gg          , Gs          , Gs          , Ce          , 2 Ke        , Ce          , Hh          
Gs^Ft       , Gs^Edpp     , Gs^Edpp     , Gs^Edpp     , Gs^Vht      , Gs^Edpp     , Hh          , Gs^Edpp     , Gs          , Gs          , Gs          , Hh          , Mm^Xm       , Mm^Xm       , Hh          , Hh          , Gg^Ft       , Gg^Ft       , Wog         , Wog         , Gg          , Gg          , Gs          , Gs          , Gs          , Gs          , Hh          , Ce          , Mm          , Mm          
Gs^Edpp     , Gs^Edpp     , Gs^Edpp     , Hh          , Hh          , Hh          , Gs^Edpp     , Gs^Edpp     , Gs          , Gs          , Gs^Edpp     , Hh          , Hh          , Hh          , Gs          , Gs^Vht      , Gg^Ft       , Wwg^Ft      , Wog         , Wog         , Gg          , Gg          , Gs          , Gs          , Gs          , Gs          , Hh          , Mm          , Mm          , Mm          
Gs^Edpp     , Gs^Edpp     , Gs^Edpp     , Hh          , Gs^Edpp     , Gs^Es       , Gs          , Gs^Edpp     , Gs          , Gs^Es       , Gs^Es       , Hh          , Gs          , Gs          , Gg          , Gg          , Wog         , Wog         , Gg          , Gg          , Gs          , Gs          , Gs          , Gs          , Gs          , Hh          , Hh          , Mm          , Mm          , Mm          
Gs^Edpp     , Gs^Edpp     , Gs^Edpp     , Gs^Edpp     , Gs^Edpp     , Gs^Edpp     , Gs          , Gs^Edpp     , Gs          , Gs^Es       , Gs          , Hh          , Gg          , Gg          , Wwf         , Wwf         , Wwf         , Wwrg        , Gg          , Gs          , Gs          , Gs          , Gs          , Gs          , Gs          , Hh          , Hh          , Mm          , Mm          , Mm          
Gs^Ft       , Gs^Edpp     , Gs^Edpp     , Gs^Edpp     , Gs^Edpp     , Gs          , Gs          , Gs          , Hh          , Gs          , Gs^Edpp     , Gs          , Gg          , Wwf         , Wwf         , Wwf         , Gg          , Gg          , Gs          , Gs          , Hh          , Gs^Es       , Gs          , Gd          , Gs          , Hh          , Hh          , Mm          , Mm          , Mm          
Gs^Ft       , Gs^Ft       , Gs^Edpp     , Gs^Edpp     , Gs^Edpp     , Gs          , Gs^Edpp     , Gs^Edpp     , Gs^Edpp     , Gs^Edpp     , Gs^Edpp     , Gs^Edpp     , Gg          , Wwf         , Wwf         , Wwf         , Gg          , Gs          , Gs          , Gs          , Hh          , Hh          , Gd          , Gd          , Gs^Es       , Hh          , Hh          , Mm          , Mm          , Mm          
Gs^Ft       , Gs^Ft       , Gs^Edpp     , Gs^Edpp     , Gs^Ft       , Gs^Edpp     , Gs^Vht      , Gs^Vht      , Gs^Ft       , Gs^Edpp     , Gs^Edpp     , Gs^Edpp     , Gg          , Wwf         , Wwf^Es      , Gg          , Gs          , Gs          , Hh          , Hh          , Gs^Edpp     , Gs^Edpp     , Gs^Edpp     , Gs          , Gs^Es       , Gs^Es       , Hh          , Mm          , Mm          , Mm          
Gs^Ft       , Gs^Ft       , Gs          , Gs^Edpp     , Gg^Ft       , Gg^Ft       , Gg^Ft       , Gs^Ft       , Gg^Ft       , Gs^Ft       , Gg^Ft       , Gg^Ft       , Wwrg        , Wwf         , Wwf         , Gg          , Gs          , Gs          , Gs^Edpp     , Gs^Edpp     , Gs^Edpp     , Gs^Edpp     , Gs          , Gd          , Hh          , Hh          , Hh          , Mm          , Mm          , Mm          
Gg^Ft       , Gg^Ft       , Gg          , Gg^Ft       , Gg^Ft       , Ss          , Ss          , Gg^Ft       , Ss          , Gg^Ft       , Ss^Ft       , Wwrg        , Wwg         , Wog         , Gg^Ft       , Gg^Edpp     , Gs^Edpp     , Gs          , Gd          , Gs^Edpp     , Gs^Vht      , Gs^Vht      , Gs          , Gs^Edpp     , Gs^Edpp     , Hh          , Hh          , Mm          , Mm          , Mm          
Ss          , Ss          , Ss          , Ss          , Ss          , Ss          , Gg^Ft       , Ss          , Gg^Ft       , Ss          , Ss          , Ss          , Wwg         , Wwg         , Gg^Ft       , Gs^Edpp     , Gs^Edpp     , Gd          , Gs^Edpp     , Gs          , Gs          , Gs          , Gs          , Gs^Vht      , Gs^Edpp     , Hh          , Hh          , Hh          , Mm          , Mm          
Gg^Ft       , Gg^Ft       , Gg          , Gg^Ft       , Gg^Ft       , Ss          , Ss          , Ss          , Ss          , Ss          , Hh          , Hh          , Wwg         , Wwf         , Gg^Ft       , Gs^Ft       , Gs^Edpp     , Gd          , Gs^Edpp     , Gs^Vht      , Gs^Vht      , Gs          , Gs^Edpp     , Gs^Vht      , Gs^Edpp     , Gs^Edpp     , Hh          , Hh          , Mm          , Mm          
Gs^Ft       , Gs^Ft       , Gs          , Gs          , Gs          , Gg^Ft       , Gg^Ft       , Gg^Ft       , Gg^Ft       , Gg^Ft       , Gs^Ft       , Hh          , Wwf^Es      , Wwf         , Gg^Edpp     , Gs^Edpp     , Gs          , Gd          , Gs^Edpp     , Gs^Edpp     , Gs^Edpp     , Gs^Edpp     , Gs^Edpp     , Gs^Edpp     , Gs^Edpp     , Gs          , Gs          , Hh          , Hh          , Mm          
Gs^Ft       , Gs          , Gs          , Gs          , Gs          , Gs          , Gs          , Gs^Ft       , Gs^Vht      , Gs^Ft       , Gs^Vht      , Gg^Ft       , Wwf         , Wwf         , Gg          , Gs          , Gs          , Gs          , Hh          , Gs^Edpp     , Hh          , Gs^Edpp     , Hh          , Gs^Edpp     , Gd^Edpp     , Gd^Edpp     , Gd^Edpp     , Gs          , Hh          , Hh          
Gs^Ft       , Gs^Ft       , Gs          , Gs          , Gs          , Gs          , Gs          , Gs          , Gs          , Gs          , Gs          , Gg          , Wwf         , Wwf         , Gg          , Gs          , Gs          , Hh          , Gs^Edpp     , Hh          , Gs^Edpp     , Hh          , Gs^Edpp     , Gs^Edpp     , Gs^Edpp     , Gd^Edpp     , Gs^Edpp     , Gs^Edpp     , Gs^Vht      , Hh          
Gs^Ft       , Gs^Ft       , Co          , Co          , Co          , Gs          , Gs^Ft       , Gs          , Gs          , Gs          , Gs          , Gg          , Wwf         , Wwf^Es      , Hh          , Gs          , Gs          , Gs          , Gd^Edpp     , Gs^Edpp     , Gs          , Gs          , Gg          , Gs          , Gs          , Gs^Edpp     , Gs^Vht      , Gs^Edpp     , Gs^Vht      , Gs          
Gg^Ft       , Gg^Ft       , Co          , 1 Ko        , Co          , Gg^Ft       , Gg^Ft       , Gs^Ft       , Gs^Ft       , Gs          , Gs^Vht      , Gg^Vht      , Wwf^Es      , Wwf^Es      , Hh          , Hh          , Hh          , Hh          , Gs          , Gs          , Gg          , Gg          , Wwf         , Gg          , Hh          , Gs          , Gs          , Gs          , Gg          , Gg          
Ss          , Ss          , Ss          , Co          , Ss          , Ss          , Ss          , Gg^Ft       , Gs^Ft       , Hh          , Gg^Ft       , Hh          , Wwf^Es      , Wwf^Es      , Hh          , Mm          , Mm          , Hh          , Gg          , Gg          , Wwf         , Wwg         , Gg          , Wwf         , Wwf         , Gg          , Gg          , Gg          , Wwf         , Wwf         
Gg^Ft       , Ss          , Gg          , Ss^Bw|      , Gg^Ft       , Ss          , Ss          , Gg^Ft       , Gg^Ft       , Gg^Ft       , Ss          , Ss          , Wwg^Es      , Wwrg        , Hh          , Mm^Xm       , Hh          , Hh          , Wwf         , Wwf         , Gg          , Gg          , Hh          , Gg          , Gg          , Wwf         , Wwf         , Wwf         , Gg          , Gg          
Gs^Ft       , Gg^Ft       , Gs          , Gg          , Gs^Vht      , Gg^Ft       , Gg^Ft       , Ss          , Ss          , Gg^Ft       , Ss          , Gg^Ft       , Wwg         , Ds          , Gs^Vht      , Mm          , Wwf         , Wwf         , Gg          , Gg          , Hh          , Hh          , Mm          , Hh          , Hh          , Gg          , Gg          , Gg          , Gs          , Gs          
Gs^Ft       , Gs^Ft       , Gs^Edpp     , Gs          , Gs^Edpp     , Gs^Ft       , Gs^Ft       , Gg^Ft       , Gg^Ft       , Ss          , Ss          , Ss          , Wwg         , Ds          , Hh          , Mm          , Wwf         , Gg          , Hh          , Gs          , Hh          , Mm          , Hh          , Mm          , Hh          , Hh          , Gs          , Gs          , Gs          , Gs          
Gs^Ft       , Gs^Edpp     , Gs^Edpp     , Gs          , Gs^Vht      , Gs^Edpp     , Gs^Edpp     , Gs^Vht      , Gs^Edpp     , Gg^Ft       , Gg^Ft       , Gg^Ft       , Wwf         , Ds          , Hh          , Ds          , Wwf         , Gg          , Gs          , Hh          , Gs          , Hh          , Gs^Vht      , Hh          , Gs          , Gs          , Gs          , Gs          , Gs          , Gs          
Gs^Edpp     , Gs^Edpp     , Gs^Edpp     , Gs          , Gs          , Gs^Vht      , Gs          , Gs^Edpp     , Gs^Edpp     , Gs^Ft       , Gs^Ft       , Gg^Ft       , Wwf         , Ds          , Wwf         , Wwf         , Gg          , Gs          , Gs          , Gs          , Gs^Vht      , Gs          , Gd          , Gs          , Gs          , Gs          , Gs          , Gd          , Gd          , Gs          
Gs^Edpp     , Gs^Edpp     , Gs          , Gs          , Gs          , Gs          , Gs          , Gs          , Gs          , Gs^Edpp     , Hh          , Gg^Ft       , Wwg         , Wwf         , Gg          , Gg          , Gs          , Gs          , Gs^Es       , Gs          , Gs^Vht      , Gd          , Gd          , Gs          , Gs^Vht      , Gs          , Gs          , Gd          , Gs          , Gs          
Gs^Edpp     , Gs^Edpp     , Gs          , Gs          , Gd          , Gd          , Gd          , Gd          , Gd          , Gs          , Gs          , Gg^Ft       , Wog         , Gg          , Gs          , Gs^Es       , Gs^Es       , Gs^Es       , Gs^Edpp     , Gs          , Gs          , Gs          , Gs          , Gs          , Gs^Vht      , Gs          , Gs          , Gd          , Gs          , Gs          
Gs^Ft       , Gs^Edpp     , Gs          , Gd          , Gd          , Gd          , Gs          , Gs          , Gs^Es       , Gs          , Gs          , Gg          , Wog         , Gg          , Gs          , Gs^Edpp     , Gs^Es       , Gs^Edpp     , Hh          , Gs          , Gs^Vht      , Gs          , Gs          , Gs^Vht      , Gs          , Gs          , Gs          , Gd          , Gs          , Gs          
Gs^Ft       , Gs^Edpp     , Gs^Edpp     , Gs          , Gd          , Gs          , Gs^Es       , Hh          , Gs^Es       , Gs^Es       , Gs          , Gg          , Wog         , Gg          , Gs          , Gs^Es       , Gs          , Gs          , Gs          , Hh          , Hh          , Hh          , Gs          , Gs          , Gs          , Gs          , Gd          , Gd          , Gs          , Gs          
Gs^Ft       , Gs^Ft       , Gs^Edpp     , Gs          , Gd          , Gs          , Gs          , Hh          , Hh          , Hh          , Gs          , Gg          , Wog         , Gg          , Gs          , Gs          , Gd          , Gs          , Gs          , Gs          , Gs          , Gs          , Gs          , Gs          , Gd          , Gd          , Gd          , Gs          , Gs^Edpp     , Gs^Edpp     
Gs^Ft       , Gs^Ft       , Gs^Ft       , Gs^Edpp     , Gs^Edpp     , Gd          , Gs          , Gs          , Gs          , Gs^Es       , Gs          , Gg          , Wog         , Gg          , Gs          , Gs          , Gs          , Gd          , Gd          , Gs          , Gd          , Gd          , Gd          , Gd          , Gs          , Gs          , Gd          , Gs          , Gs^Edpp     , Gs^Edpp     
Gs^Ft       , Gs^Ft       , Gs^Ft       , Gs^Ft       , Gs^Ft       , Gs^Edpp     , Gs^Edpp     , Gs          , Gs          , Gs          , Gs          , Gg          , Wog^Bw\     , Gg          , Gs          , Gs          , Gs          , Gs          , Gd          , Gd          , Gd          , Gd          , Gd          , Gd          , Gd          , Gd          , Gs          , Gs          , Gs^Edpp     , Gs^Edpp     
Gs^Ft       , Gs^Ft       , Gs^Ft       , Gs^Ft       , Gs^Ft       , Gs^Ft       , Gs^Ft       , Gs^Vht      , Gs^Vht      , Gs          , Gs          , Gg          , Wog         , Gg          , Gs          , Gs          , Gs          , Gs          , Gs          , Gd          , Gd          , Gd          , Gs          , Gs          , Gs          , Gs          , Ce          , Ce          , Ce          , Gs^Edpp     
Gs^Ft       , Gs^Ft       , Gs^Ft       , Gs^Ft       , Gs^Ft       , Gs^Ft       , Gs^Ft       , Gs^Ft       , Gs^Ft       , Gs^Ft       , Gs^Ft       , Gg^Vht      , Wog         , Gg^Vht      , Gs^Edpp     , Gs^Edpp     , Gs^Edpp     , Gs^Edpp     , Gs^Edpp     , Gs^Edpp     , Gs^Edpp     , Gs^Edpp     , Gs^Edpp     , Gs^Edpp     , Gs^Edpp     , Gs          , Ce          , 3 Ke        , Ce          , Gs^Edpp     
Gs^Ft       , Gs^Ft       , Gs^Ft       , Gs^Ft       , Gs^Ft       , Gs^Ft       , Gs^Ft       , Gs^Ft       , Gs^Ft       , Gs^Ft       , Gs^Ft       , Gs^Ft       , Wog         , Gg^Edpp     , Gs^Edpp     , Gs^Edpp     , Gs          , Gs^Edpp     , Gs^Edpp     , Gs^Edpp     , Gs^Edpp     , Gs^Ft       , Gs^Ft       , Gs^Ft       , Gs^Edpp     , Gs^Edpp     , Gs^Edpp     , Ce          , Gs^Edpp     , Gs^Edpp     
