border_size=1
usage=map

Gs^Ft       , Gs^Ft       , Gs^Ft       , Gs^Ft       , Gs^Ft       , Gs^Ft       , Gs^Ft       , Gs^Ft       , Gs^Ft       , Gs^Ft       , Gs^Ft       , Gs^Ft       , Gs^Ft       , Gs^Ft       , Gs^Ft       , Hh          , Hh          , Hh          , Hh          , Hh          , Gs^Ft       , Gs^Ft       , Rb          , Rb          , Gs^Ft       , Gs^Ft       , Hh          , Hh          , Gs^Ft       , Gs^Ft       , Gs^Ft       , Gs^Ft       , Gs^Ft       , Gs^Ft       , Gs^Ft       , Gs^Ft       , Gs^Ft       , Gs^Ft       , Ss          , Ss          , Ss          , Gs^Ft       , Gs^Ft       , Gs^Ft       , Gs^Ft       , Gs^Ft       
Gs^Ft       , Gs^Ft       , Gs^Ft       , Gs^Ft       , Gs^Ft       , Gs^Ft       , Gs^Ft       , Rb          , Gs^Ft       , Gs^Ft       , Gs^Ft       , Gs^Ft       , Ce          , Gs^Ft       , Gs^Ft       , Gs^Ft       , Hh          , Hh          , Hh          , Gs^Ft       , Gs^Ft       , Gs^Ft       , Rb          , Rb          , Gs^Ft       , Gs^Ft       , Hh          , Hh          , Gs^Ft       , Gs^Ft       , Gs^Ft       , Gs^Ft       , Gs^Ft       , Gs^Ft       , Gs^Ft       , Gs^Ft       , Gs^Ft       , Gs^Ft       , Ss          , Ss          , Ss          , Gs^Ft       , Gs^Ft       , Gs^Ft       , Gs^Ft       , Gs^Ft       
Gs^Ft       , Gs^Ft       , Gs^Ft       , Gs^Ft       , Rb^Ft       , Rb^Ft       , Rb^Ft       , Gs^Ft       , Gs^Ft       , Gs^Ft       , Gs^Ft       , Ce          , 2 Ke        , Ce          , Gs^Ft       , Gs^Ft       , Rb^Ft       , Hh          , Rb^Ft       , Gs^Ft       , Gs^Ft       , Gs^Ft       , Rb          , Rb          , Gs^Ft       , Gs^Ft       , Hh          , Rb^Vhs      , Rb          , Gs^Ft       , Rb^Ft       , Gs^Ft       , Gs^Ft       , Gs^Ft       , Gs^Ft       , Gs^Ft       , Gs^Ft       , Gs^Ft       , Ss          , Ss          , Gs^Ft       , Gs^Ft       , Gs^Ft       , Gs^Ft       , Gs^Ft       , Gs^Ft       
Gs^Ft       , Gs^Ft       , Gs^Ft       , Gs^Ft       , Gs^Ft       , Rb^Ft       , Rb^Vhs      , Rb^Ft       , Rb^Ft       , Gs^Ft       , Gs^Ft       , Ce          , Ce          , Ce          , Gs^Ft       , Gs^Ft       , Rb^Ft       , Hh          , Hh^Vo       , Hh          , Gs^Ft       , Gs^Ft       , Rb          , Rb          , Rb^Ft       , Ss          , Gs^Ft       , Gs^Ft       , Rb^Ft       , Rb^Ft       , Gs^Ft       , Rb^Ft       , Rb^Ft       , Gs^Ft       , Ce          , Ce          , Ss          , Ss          , Ss          , Ss          , Gs^Ft       , Gs^Ft       , Gs^Ft       , Ss^Vhs      , Gs^Ft       , Gs^Ft       
Gs^Ft       , Ss          , Ss          , Gs^Ft       , Gs^Ft       , Gs^Ft       , Hh          , Gs^Ft       , Hh          , Gs^Ft       , Gs^Ft       , Gs^Ft       , Gs^Ft       , Rb^Edpp     , Gs^Ft       , Gs^Ft       , Rb^Ft       , Hh          , Hh          , Hh          , Gs^Ft       , Gs^Ft       , Rb          , Rb          , Rb^Ft       , Rb^Ft       , Rb^Ft       , Rb^Ft       , Gs^Ft       , Gs^Ft       , Gs^Ft       , Gs^Ft       , Gs^Ft       , Ce          , Ce          , Ce          , Ss          , Ss          , Gs^Ft       , Gs^Ft       , Gs^Ft       , Gs^Ft       , Ss          , Ss          , Ss          , Ss          
Ss          , Ss          , Ss          , Gs^Ft       , Hh          , Hh          , Mm          , Hh          , Mm          , Hh          , Hh          , Gs^Ft       , Gs^Ft       , Rb^Edpp     , Gs^Ft       , Gs^Ft       , Hh          , Hh          , Hh          , Rb^Ft       , Sm          , Gs^Ft       , Rb          , Rb          , Hh          , Hh          , Hh          , Gs^Ft       , Hh          , Hh          , Hh          , Gs^Ft       , Gs^Ft       , Ce          , Ce          , 1 Ke        , Ss          , Ss          , Gs^Ft       , Gs^Ft       , Ss          , Ss          , Ss          , Ss          , Ss          , Ss          
Ss          , Ss          , Gs^Ft       , Ss          , Ss          , Mm          , Ss          , Mm          , Hh          , Mm          , Hh          , Hh          , Rb^Vhs      , Rb^Edpp     , Gs^Ft       , Gs^Ft       , Gs^Ft       , Rb^Ft       , Hh          , Rb^Ft       , Gs^Ft       , Gs^Ft       , Rb^Edpp     , Rb          , Hh          , Hh          , Gs^Ft       , Hh          , Hh          , Hh          , Rb^Edpp     , Gs^Ft       , Rb^Edpp     , Ce          , Ss          , Ss          , Ss          , Ss          , Ss          , Ss          , Ss          , Ss          , Gs^Ft       , Gs^Ft       , Gs^Ft       , Gs^Ft       
Ss          , Ss          , Gs^Ft       , Gs^Ft       , Gs^Ft       , Ss          , Ss          , Hh          , Rb^Edpp     , Hh          , Hh          , Hh          , Hh          , Rb^Edpp     , Gs^Ft       , Gs^Ft       , Gs^Ft       , Gs^Ft       , Gs^Ft       , Gs^Ft       , Gs^Ft       , Gs^Ft       , Rb          , Rb          , Rb^Ft       , Rb^Ft       , Gs^Ft       , Gs^Ft       , Rb^Vo       , Rb^Edpp     , Rb^Edpp     , Rb^Edpp     , Ss          , Ss          , Ss          , Ss          , Gs^Ft       , Ss          , Ss          , Ss          , Gs^Ft       , Gs^Ft       , Hh          , Gs^Ft       , Gs^Ft       , Gs^Ft       
Ss          , Ss          , Gs^Ft       , Gs^Ft       , Ss^Vhs      , Rb^Ft       , Ss          , Rb^Edpp     , Gs^Ft       , Rb^Edpp     , Rb^Edpp     , Rb^Edpp     , Rb^Edpp     , Rb^Edpp     , Rb^Edpp     , Gs^Ft       , Gs^Ft       , Gs^Ft       , Gs^Ft       , Gs^Ft       , Rb^Edpp     , Rb^Edpp     , Rb          , Rb          , Rb^Edpp     , Rb^Ft       , Rb^Ft       , Rb^Ft       , Rb^Edpp     , Rb^Edpp     , Ss          , Ss          , Ss          , Ss          , Ss          , Gs^Ft       , Gs^Ft       , Gs^Ft       , Gs^Ft       , Gs^Ft       , Hh          , Hh          , Hh          , Hh          , Hh          , Hh          
Ss          , Ss          , Ss          , Gs^Ft       , Ss          , Ss          , Rb^Edpp     , Rb^Edpp     , Gs^Ft       , Gs^Ft       , Gs^Ft       , Gs^Ft       , Gs^Ft       , Rb^Edpp     , Gs^Ft       , Rb^Edpp     , Rb^Edpp     , Rb^Edpp     , Rb^Edpp     , Rb^Ft       , Rb          , Rb          , Rb          , Rb          , Rb          , Rb^Edpp     , Rb^Edpp     , Rb^Edpp     , Ss          , Ss          , Ss          , Ss          , Gs^Ft       , Ss          , Ss          , Gs^Ft       , Gs^Ft       , Gs^Ft       , Gs^Ft       , Hh^Vo       , Gs^Ft       , Hh          , Gs^Ft       , Hh          , Hh          , Hh          
Ss          , Gs^Ft       , Ss          , Ss          , Rb^Ft       , Ss          , Rb^Edpp     , Gs^Ft       , Rb^Ft       , Rb^Ft       , Gs^Ft       , Gs^Ft       , Gs^Ft       , Gs^Ft       , Gs^Ft       , Gs^Ft       , Rb^Ft       , Rb^Edpp     , Rb          , Rb          , Rb          , Rb          , Rb          , Rb          , Rb          , Rb          , Ss^Bw\      , Ss          , Ss          , Ss          , Gs^Ft       , Gs^Ft       , Gs^Ft       , Ss          , Ss          , Gs^Ft       , Gs^Ft       , Gs^Ft       , Rb^Ft       , Rb^Ft       , Rb^Ft       , Rb^Ft       , Gs^Ft       , Gs^Ft       , Gs^Ft       , Hh          
Ss          , Ss          , Ss          , Ss          , Sm          , Rb^Em       , Rb^Edpp     , Gs^Ft       , Gs^Ft       , Gs^Ft       , Hh          , Hh          , Gs^Ft       , Gs^Ft       , Gs^Ft       , Gs^Ft       , Rb          , Rb          , Rb          , Rb          , Rb          , Rb          , Rb          , Rb          , Ss          , Ss          , Ss          , Ss^Bw\      , Rb          , Gs^Ft       , Gs^Ft       , Gs^Ft       , Gs^Ft       , Gs^Ft       , Ss          , Gs^Ft       , Gs^Ft       , Gs^Ft       , Gs^Ft       , Rb^Ft       , Gs^Ft       , Ss          , Gs^Ft       , Gs^Ft       , Gs^Ft       , Gs^Ft       
Gs^Ft       , Ss          , Gs^Ft       , Rb^Ft       , Sm          , Rb^Ft       , Hh          , Gs^Ft       , Hh          , Hh          , Gs^Ft       , Gs^Ft       , Rb^Ft       , Rb^Ft       , Gs^Ft       , Rb^Ft       , Rb          , Rb          , Rb          , Rb          , Rb          , Rb^Vhs      , Rb          , Rb          , Ss          , Ss          , Rb          , Rb          , Rb          , Rb^Edpp     , Gs^Ft       , Gs^Ft       , Gs^Ft       , Gs^Ft       , Ss          , Ss          , Ss          , Gs^Ft       , Ss          , Gs^Ft       , Gs^Ft       , Rb^Ft       , Gs^Ft       , Gs^Ft       , Rb^Ft       , Gs^Ft       
Ss          , Rb^Ft       , Gs^Ft       , Rb^Ft       , Sm          , Hh          , Hh          , Hh          , Gs^Ft       , Gs^Ft       , Gs^Ft       , Rb^Ft       , Sm          , Rb^Ft       , Gs^Ft       , Rb^Ft       , Rb          , Rb          , Rb          , Rb          , Rb          , Rb          , Rb          , Rb          , Ss          , Ss          , Rb          , Rb^Vhs      , Rb          , Rb^Edpp     , Gs^Ft       , Gs^Ft       , Rb^Ft       , Gs^Ft       , Gs^Ft       , Ss          , Ss          , Ss          , Gs^Ft       , Ss          , Ss          , Gs^Ft       , Gs^Ft       , Gs^Ft       , Gs^Ft       , Gs^Ft       
Ss          , Ss          , Ss          , Rb^Ft       , Sm          , Hh          , Hh          , Hh^Vo       , Hh          , Gs^Ft       , Hh          , Gs^Ft       , Gs^Ft       , Gs^Ft       , Rb^Ft       , Rb^Em       , Rb          , Rb          , Rb          , Rb          , Rb          , Rb          , Co          , Co          , Ss          , Ss          , Rb          , Rb          , Rb          , Rb^Edpp     , Gs^Ft       , Rb^Ft       , Ss          , Rb^Ft       , Ss          , Ss          , Ss          , Gs^Ft       , Gs^Ft       , Ss          , Gs^Ft       , Gs^Ft       , Hh          , Gs^Ft       , Hh          , Hh          
Ss          , Ss          , Gs^Ft       , Ss          , Sm          , Rb^Ft       , Gs^Ft       , Hh          , Gs^Ft       , Hh          , Gs^Ft       , Gs^Ft       , Gs^Ft       , Rb^Vhs      , Rb^Edpp     , Rb          , Rb          , Rb          , Rb          , Rb          , Rb          , Rb          , Co          , Ko          , Ss          , Ss          , Rb          , Rb          , Rb          , Rb^Ft       , Gs^Ft       , Gs^Ft       , Gs^Ft       , Gs^Ft       , Ss          , Gs^Ft       , Gs^Ft       , Ss^Vhs      , Gs^Ft       , Gs^Ft       , Hh          , Hh          , Mm          , Hh          , Mm          , Mm          
Ss          , Gs^Ft       , Gs^Ft       , Ss          , Rb^Edpp     , Rb^Ft       , Gs^Ft       , Hh          , Gs^Ft       , Gs^Ft       , Gs^Ft       , Gs^Ft       , Rb^Edpp     , Rb^Ft       , Rb^Edpp     , Rb          , Rb          , Rb          , Rb          , Rb          , Rb          , Rb          , Ss          , Ss          , Ss          , Ss          , Rb          , Rb          , Rb          , Rb^Ft       , Gs^Ft       , Gs^Ft       , Gs^Ft       , Gs^Ft       , Ss          , Ss          , Gs^Ft       , Gs^Ft       , Gs^Ft       , Hh          , Hh          , Hh          , Hh          , Mm          , Hh          , Mm          
Ss          , Rb^Ft       , Ss          , Ss          , Rb^Ft       , Rb^Edpp     , Gs^Ft       , Gs^Ft       , Rb^Edpp     , Gs^Ft       , Rb^Edpp     , Rb^Edpp     , Rb^Ft       , Rb^Edpp     , Rb^Ft       , Rb          , Rb          , Rb          , Rb          , Rb          , Rb          , Ss          , Ss          , Ss          , Rb          , Rb          , Rb          , Rb          , Rb          , Rb^Ft       , Gs^Ft       , Rb^Vhs      , Gs^Ft       , Gs^Ft       , Gs^Ft       , Ss          , Ss          , Ss          , Ss          , Gs^Ft       , Gs^Ft       , Gs^Ft       , Rb^Ft       , Gs^Ft       , Gs^Ft       , Hh          
Ss          , Ss          , Gs^Ft       , Gs^Ft       , Rb^Edpp     , Rb^Edpp     , Rb^Edpp     , Rb^Edpp     , Rb^Edpp     , Rb^Edpp     , Gs^Ft       , Gs^Ft       , Gs^Ft       , Gs^Ft       , Gs^Ft       , Rb          , Rb          , Rb          , Rb          , Rb^Vhs      , Rb          , Ss          , Ss          , Rb          , Rb          , Rb          , Rb          , Rb          , Rb          , Rb^Ft       , Hh          , Hh          , Hh          , Gs^Ft       , Hh          , Gs^Ft       , Gs^Ft       , Ss          , Ss          , Gs^Ft       , Gs^Ft       , Rb^Vo       , Gs^Ft       , Rb^Ft       , Hh          , Gs^Ft       
Gs^Ft       , Gs^Ft       , Gs^Ft       , Gs^Ft       , Rb^Edpp     , Rb^Edpp     , Gs^Ft       , Rb^Ft       , Gs^Ft       , Gs^Ft       , Gs^Ft       , Gs^Ft       , Gs^Ft       , Gs^Ft       , Ss          , Rb^Em       , Rb          , Rb          , Rb          , Rb          , Ss          , Ss          , Ss          , Rb          , Rb          , Rb^Vhs      , Rb          , Rb          , Rb          , Rb^Edpp     , Hh          , Mm          , Hh          , Hh          , Hh          , Hh          , Ce          , Ce          , Ce          , Gs^Ft       , Gs^Ft       , Gs^Ft       , Gs^Ft       , Gs^Ft       , Hh          , Hh          
Gs^Ft       , Gs^Ft       , Rb^Edpp     , Rb^Edpp     , Rb^Edpp     , Gs^Ft       , Gs^Ft       , Gs^Ft       , Rb^Vhs      , Gs^Ft       , Gs^Ft       , Gs^Ft       , Ss          , Ss          , Gs^Ft       , Ss          , Ss          , Rb          , Ss^Bw\      , Ss          , Ss          , Ss          , Rb          , Rb          , Rb          , Rb          , Rb          , Rb          , Rb          , Rb^Edpp     , Gs^Ft       , Hh          , Gs^Ft       , Hh          , Hh          , Hh          , Ce          , 3 Ke        , Ce          , Hh          , Hh          , Gs^Ft       , Hh          , Hh          , Mm          , Mm          
Rb^Edpp     , Rb^Edpp     , Gs^Ft       , Gs^Ft       , Rb^Edpp     , Gs^Ft       , Gs^Ft       , Rb^Ft       , Rb^Ft       , Rb^Ft       , Gs^Ft       , Gs^Ft       , Ss          , Gs^Ft       , Gs^Ft       , Ss          , Ss          , Ss          , Ss          , Ss^Bw\      , Rb          , Rb          , Rb          , Rb          , Rb          , Rb          , Rb          , Rb          , Rb          , Rb^Edpp     , Rb^Edpp     , Rb^Vct      , Rb^Edpp     , Gs^Ft       , Rb^Edpp     , Hh          , Rb          , Ce          , Hh          , Hh          , Hh          , Hh          , Mm          , Mm          , Mm          , Mm          
Gs^Ft       , Gs^Ft       , Ce          , Rb^Edpp     , Gs^Ft       , Gs^Ft       , Gs^Ft       , Gs^Ft       , Gs^Ft       , Gs^Ft       , Gs^Ft       , Ss          , Gs^Ft       , Gs^Ft       , Gs^Ft       , Ss          , Ss          , Ss          , Ss^Vhs      , Ss          , Rb          , Rb          , Rb          , Rb          , Rb          , Rb          , Rb          , Rb          , Ss          , Rb^Edpp     , Rb^Ft       , Rb^Edpp     , Rb^Edpp     , Rb^Edpp     , Gs^Ft       , Rb^Edpp     , Hh          , Hh          , Mm          , Mm          , Mm          , Mm          , Mm          , Mm          , Mm          , Mm          
Gs^Ft       , Ce          , 5 Ke        , Ce          , Gs^Ft       , Gs^Ft       , Ss          , Ss          , Ss          , Ss          , Ss          , Ss          , Gs^Ft       , Gs^Ft       , Rb^Ft       , Gs^Ft       , Gs^Ft       , Gs^Ft       , Ss          , Ss          , Ss          , Rb          , Rb          , Rb          , Rb          , Rb          , Rb^Edpp     , Rb^Em       , Ss          , Ss          , Gs^Ft       , Gs^Ft       , Gs^Ft       , Gs^Ft       , Hh          , Hh          , Hh          , Hh^Vo       , Hh          , Hh          , Hh          , Hh          , Hh          , Mm          , Mm          , Mm          
Gs^Ft       , Ce          , Ce          , Ce          , Ss          , Ss          , Ss^Vhs      , Gs^Ft       , Gs^Ft       , Gs^Ft       , Gs^Ft       , Ss          , Gs^Ft       , Rb^Ft       , Sm          , Rb^Ft       , Gs^Ft       , Gs^Ft       , Ss          , Ss          , Ss          , Rb^Em       , Rb          , Rb          , Gs^Ft       , Gs^Vhs      , Rb^Edpp     , Gs^Ft       , Gs^Ft       , Ss          , Ss          , Gs^Ft       , Ss          , Gs^Ft       , Gs^Ft       , Gs^Ft       , Gs^Ft       , Ss          , Ss          , Gs^Ft       , Gs^Ft       , Hh          , Hh          , Hh          , Hh          , Mm          
Gs^Ft       , Gs^Ft       , Ss          , Ss          , Ss          , Gs^Ft       , Gs^Ft       , Gs^Ft       , Ss          , Ss          , Ss          , Ss          , Gs^Ft       , Rb^Ft       , Rb^Ft       , Rb^Ft       , Gs^Ft       , Gs^Ft       , Ss          , Ss          , Ss          , Ss          , Ss          , Gs^Ft       , Gs^Ft       , Gs^Ft       , Rb^Edpp     , Rb^Ft       , Gs^Ft       , Gs^Ft       , Rb^Ft       , Ss          , Ss          , Gs^Ft       , Gs^Ft       , Gs^Ft       , Gs^Ft       , Ss          , Rb^Ft       , Rb^Ft       , Gs^Ft       , Gs^Ft       , Hh          , Hh          , Hh          , Hh          
Ss          , Ss          , Gs^Ft       , Ss          , Ss          , Gs^Ft       , Rb^Ft       , Gs^Ft       , Ss          , Gs^Ft       , Gs^Ft       , Gs^Ft       , Gs^Ft       , Ss^Vhs      , Gs^Ft       , Gs^Ft       , Ss          , Ss          , Ss          , Ss          , Gs^Ft       , Ss          , Gs^Ft       , Gs^Ft       , Rb^Ft       , Gs^Ft       , Rb^Edpp     , Rb^Ft       , Gs^Ft       , Gs^Ft       , Rb^Ft       , Ss          , Ss          , Gs^Ft       , Gs^Ft       , Gs^Ft       , Ss          , Ss          , Gs^Ft       , Rb^Ft       , Gs^Ft       , Gs^Ft       , Gs^Ft       , Hh          , Hh          , Hh          
Ss          , Ss          , Gs^Ft       , Ss          , Ss          , Rb^Ft       , Gs^Ft       , Gs^Ft       , Ss          , Gs^Ft       , Gs^Ft       , Gs^Ft       , Ss          , Ss          , Ss          , Ss          , Ss          , Rb^Ft       , Rb^Ft       , Gs^Ft       , Gs^Ft       , Rb^Ft       , Rb^Ft       , Rb^Ft       , Gs^Ft       , Gs^Ft       , Rb^Edpp     , Rb^Edpp     , Gs^Ft       , Gs^Ft       , Rb^Ft       , Gs^Ft       , Ss          , Ss          , Ss          , Ss          , Ss          , Ss          , Gs^Ft       , Gs^Ft       , Gs^Ft       , Gs^Ft       , Rb^Ft       , Gs^Ft       , Gs^Ft       , Hh          
Ss          , Gs^Ft       , Rb^Ft       , Gs^Ft       , Ss          , Gs^Ft       , Gs^Ft       , Gs^Ft       , Ss          , Ss          , Ss          , Ss          , Rb^Ft       , Rb^Ft       , Gs^Ft       , Ss          , Gs^Ft       , Ss          , Ss          , Gs^Ft       , Gs^Ft       , Gs^Ft       , Gs^Ft       , Gs^Ft       , Gs^Ft       , Gs^Ft       , Sm          , Rb^Edpp     , Rb^Edpp     , Gs^Ft       , Gs^Ft       , Rb^Ft       , Ss          , Ss          , Wwg         , Ss          , Wwg         , Ss          , Ss          , Gs^Ft       , Gs^Ft       , Rb^Ft       , Rb^Ft       , Gs^Ft       , Gs^Ft       , Gs^Ft       
Ss          , Gs^Ft       , Rb^Ft       , Gs^Ft       , Gs^Ft       , Ss          , Ss          , Ss          , Ss          , Ss          , Ss          , Ss          , Rb^Ft       , Gs^Ft       , Rb^Ft       , Ss          , Ss          , Ss          , Gs^Ft       , Ss          , Ss          , Ss          , Ss          , Ss          , Ss          , Ss          , Ss          , Sm          , Rb^Edpp     , Gs^Ft       , Gs^Ft       , Gs^Ft       , Ss          , Wwg         , Wwg         , Wwg         , Wog         , Wwg         , Wwg         , Ss          , Ss          , Gs^Ft       , Gs^Ft       , Gs^Ft       , Rb^Ft       , Gs^Ft       
Ss          , Gs^Ft       , Gs^Ft       , Gs^Ft       , Gs^Ft       , Ss          , Ss          , Gs^Ft       , Gs^Ft       , Gs^Ft       , Gs^Ft       , Ss          , Ss          , Ss          , Ss^Vhs      , Ss          , Gs^Ft       , Gs^Ft       , Gs^Ft       , Gs^Ft       , Rb^Ft       , Ss^Vhs      , Rb^Ft       , Ss          , Gs^Ft       , Ss          , Ce          , Ce          , Ce          , Gs^Ft       , Gs^Ft       , Gs^Ft       , Ss^Bw/      , Wwg         , Wog         , Wog         , Wog         , Wog         , Wog         , Wwg         , Wwg         , Ss          , Gs^Ft       , Gs^Ft       , Rb^Ft       , Gs^Ft       
Ss          , Gs^Ft       , Ss          , Ss          , Ss          , Ss          , Ss^Vhs      , Gs^Ft       , Rb^Ft       , Gs^Ft       , Gs^Ft       , Gs^Ft       , Gs^Ft       , Gs^Ft       , Gs^Ft       , Gs^Ft       , Gs^Ft       , Gs^Ft       , Gs^Ft       , Rb^Ft       , Gs^Ft       , Rb^Ft       , Gs^Ft       , Gs^Ft       , Ss          , Ss          , Ss          , 4 Ke        , Ce          , Rb^Em       , Rb          , Rb          , Ss          , Wwg         , Wwg         , Wog         , Wwg         , Wog         , Wog         , Wog         , Wwg         , Ss          , Gs^Ft       , Gs^Ft       , Rb^Ft       , Gs^Ft       
Gs^Ft       , Ss          , Gs^Ft       , Gs^Ft       , Gs^Ft       , Gs^Ft       , Rb^Ft       , Rb^Ft       , Rb^Ft       , Rb^Ft       , Rb^Ft       , Rb^Ft       , Gs^Ft       , Gs^Ft       , Rb^Ft       , Gs^Ft       , Gs^Ft       , Gs^Ft       , Gs^Ft       , Rb^Ft       , Rb^Ft       , Gs^Ft       , Gs^Ft       , Gs^Ft       , Gs^Ft       , Ss          , Ss          , Ce          , Rb          , Rb          , Rb          , Rb^Vhs      , Ss          , Wwg         , Wwg         , Wwg         , Ss          , Wwg         , Wwg         , Wog         , Wwg         , Ss          , Gs^Ft       , Gs^Ft       , Gs^Ft       , Rb^Ft       
Gs^Ft       , Ss          , Gs^Ft       , Gs^Ft       , Gs^Ft       , Gs^Ft       , Rb^Ft       , Gs^Ft       , Gs^Ft       , Rb^Ft       , Rb^Ft       , Gs^Ft       , Gs^Ft       , Rb^Ft       , Gs^Ft       , Gs^Ft       , Gs^Ft       , Rb          , Gs^Ft       , Rb^Ft       , Rb^Ft       , Gs^Ft       , Ss          , Gs^Ft       , Gs^Ft       , Gs^Ft       , Gs^Ft       , Ss          , Ss          , Rb^Vhs      , Ss          , Ss          , Ss          , Ss          , Ss          , Ss          , Gs^Ft       , Ss          , Ss          , Wwg         , Wwg         , Ss          , Ss          , Gs^Ft       , Gs^Ft       , Gs^Ft       
Ss          , Ss          , Gs^Ft       , Gs^Ft       , Gs^Ft       , Gs^Ft       , Gs^Ft       , Gs^Ft       , Gs^Ft       , Gs^Ft       , Rb^Ft       , Gs^Ft       , Gs^Ft       , Gs^Ft       , Gs^Ft       , Gs^Ft       , Gs^Ft       , Gs^Ft       , Gs^Ft       , Rb^Ft       , Gs^Ft       , Gs^Ft       , Gs^Ft       , Ss          , Ss          , Ss          , Ss          , Ss          , Ss          , Ss          , Ss          , Ss          , Gs^Ft       , Gs^Ft       , Gs^Ft       , Gs^Ft       , Gs^Ft       , Gs^Ft       , Gs^Ft       , Ss          , Ss          , Ss          , Ss          , Gs^Ft       , Gs^Ft       , Gs^Ft       
