border_size=1
usage=map

Gs^Ft       , Gs^Ft       , Gs^Ft       , Gs^Ft       , Gs^Ft       , Gs^Ft       , Gs^Ft       , Gs^Ft       , Gs^Ft       , Gs^Ft       , Gs^Ft       , Gs^Ft       , Gs^Ft       , Gs^Ft       , Gs^Ft       , Gs^Ft       , Gs^Ft       , Gs^Ft       , Gs^Ft       , Gs^Ft       , Hh          , Hh          , Hh          , Hh          , Mm          , Mm          , Mm          , Mm          , Mm          , Mm          , Mm          , Wog         , Mm          , Mm          , Mm          , Mm          , Mm          , Mm          , Mm          , Mm          , Mm          , Mm          
Gs^Ft       , Ch          , 1 Kh        , Ch          , Gs^Ft       , Gs^Ft       , Gs^Ft       , Gs^Ft       , Gs^Ft       , Gs^Ft       , Gs^Ft       , Gs^Ft       , Gs^Ft       , Gs^Ft       , Gs^Ft       , Gs^Ft       , Gs          , Gs^Ft       , Gs^Ft       , Gs^Ft       , Gs          , Hh          , Hh          , Hh          , Hh          , Hh          , Hh          , Hh^Vhh      , Hh          , Hh          , Hh          , Wog         , Hh          , Hh^Vhh      , Mm          , Mm          , Mm          , Mm          , Mm          , Mm          , Hh          , Hh          
Gs^Ft       , Ch          , Ch          , Ch          , Re          , Gs^Ft       , Gs          , Gs^Ft       , Gs^Ft       , Gs^Ft       , Gs^Ft       , Gs^Ft       , Gs          , Gs^Ft       , Gs          , Gs          , Gs          , Gs          , Gs          , Gs          , Gs          , Gs          , Gs          , Hh          , Hh          , Hh          , Hh          , Hh          , Hh          , Hh          , Wog         , Wog         , Hh          , Hh          , Hh          , Hh          , Hh          , Mm          , Hh          , Hh          , Hh          , Hh          
Gs^Ft       , Ch          , Gs^Ft       , Gs^Ft       , Gs^Ft       , Re          , Re          , Gs          , Gs          , Gs^Ft       , Gs          , Gs          , Gs          , Gs          , Gs          , Gs          , Gs          , Gs          , Gs          , Gs          , Gs          , Gs          , Gs          , Gs          , Ce          , Re^Gvs      , Re^Gvs      , Hh          , Wwf         , Wwg         , Wwf         , Hh          , Hh          , Hh          , Hh          , Hh          , Hh          , Hh          , Hh          , Hh^Vhh      , Hh          , Hh          
Gs^Ft       , Gs^Ft       , Gs^Ft       , Gs^Ft       , Gs^Ft       , Gs          , Gs          , Re          , Re          , Gs          , Gs          , Gs          , Gs^Vht      , Gs          , Gs          , Gs          , Gs          , Gs          , Gs          , Gs          , Gs          , Gs          , Gs          , Gs          , Hh          , Re^Gvs      , Hh          , Re^Gvs      , Wwf         , Wog         , Wwf         , Re^Gvs      , Re^Gvs      , Hh          , Re          , Hh          , Gs          , Gs          , Gs          , Hh          , Gs          , Hh          
Gs^Ft       , Gs^Ft       , Gs^Ft       , Gs^Ft       , Gs^Ft       , Gs          , Gs          , Gs          , Gs          , Rrc         , Rrc         , Gs          , Gs          , Gs          , Gg          , Gg          , Gg          , Gs          , Gs          , Gs          , Gs          , Gs^Vht      , Gs          , Gs          , Gs          , Hh          , Hh          , Hh          , Hh          , Wwg         , Hh          , Hh          , Hh          , Ce          , Gs          , Gs          , Gs          , Gs          , Gs          , Gs          , Gs          , Gs          
Gs^Ft       , Gs^Ft       , Gs^Ft       , Gs^Ft       , Gs^Ft       , Gs          , Gs          , Gs          , Gs          , Gs          , Rrc         , Gs          , Gg          , Gg          , Wwg         , Wwg         , Wog         , Gg          , Gg          , Gs          , Gs          , Gs          , Gs^Ft       , Gs          , Gs          , Gs          , Gs          , Hh          , Hh          , Wwg         , Hh          , Hh          , Gs^Vht      , Hh          , Gs          , Gs          , Gs          , Gs          , Gs          , Gs          , Rrc         , Rrc         
Gs^Ft       , Gs^Ft       , Gs^Ft       , Gs^Ft       , Wwg         , Gs          , Wwg         , Gs          , Wwg         , Wwg         , Wwg^Bsb|    , Wwg         , Wwg         , Wwg         , Wog         , Wog         , Wog         , Wog         , Gg          , Gs          , Gs          , Gs          , Gs          , Gs          , Gs          , Gs          , Gs          , Gs          , Gg          , Wwg         , Gg          , Gs          , Gs          , Gs          , Gs          , Gs          , Gs          , Gs          , Rrc         , Rrc         , Hh          , Hh          
Wwg         , Wwg         , Wwg         , Wwg         , Gs^Ft       , Wwg         , Gs          , Wwg         , Gs          , Gs          , Rrc         , Gs          , Gg          , Wwg         , Wwg         , Wog         , Wog         , Wog         , Gg          , Gs          , Gs          , Gs          , Gs          , Gs          , Gs          , Gs          , Gs          , Gs          , Gg          , Wwg         , Gg          , Gs          , Gs          , Gs          , Gs          , Gs          , Rrc         , Rrc         , Hh          , Hh          , Mm          , Mm          
Gs^Ft       , Gs^Ft       , Gs^Ft       , Gs^Ft       , Gs^Ft       , Gs^Ft       , Gs^Ft       , Gs          , Gs          , Gs          , Gs^Vht      , Rrc         , Rrc         , Gg          , Gg          , Wwg         , Gg          , Gg          , Gs          , Gs          , Gs          , Gs          , Ch          , Ch          , Ch          , Gs          , Gs          , Gs          , Gg          , Wwg         , Gg          , Gs          , Gs          , Gs          , Rrc         , Rrc         , Gs          , Hh          , Mm          , Mm          , Mm          , Mm          
Gs^Ft       , Gs^Ft       , Gs^Ft       , Gs^Ft       , Gs^Ft       , Gs^Ft       , Gs          , Gs          , Gs          , Gs          , Gs          , Gs          , Gs          , Rrc         , Rrc         , Gg          , Gs          , Gs          , Gs          , Gs          , Ch          , Ch          , Ch          , 2 Kh        , Ch          , Ch          , Ch          , Gs          , Gg          , Wwg         , Gg          , Gs          , Rrc         , Rrc         , Gs          , Gs          , Gs          , Hh          , Hh          , Mm          , Mm          , Mm          
Gs^Ft       , Gs^Ft       , Gs^Ft       , Gs^Ft       , Gs^Ft       , Gs          , Gs^Ft       , Gs^Ft       , Gs^Ft       , Gs          , Gs          , Gs          , Gs          , Gs          , Gs^Vht      , Rrc         , Rrc         , Gs          , Gs          , Ch          , Rr^Vhc      , Rr^Vhc      , Rr          , Ch          , Rr          , Rr^Vhc      , Ch          , Gg          , Wwg         , Wwg         , Rrc         , Rrc         , Gs          , Gs          , Gs          , Gs          , Gs^Ft       , Gs          , Gs          , Hh          , Hh^Vhh      , Mm          
Gs^Ft       , Gs^Ft       , Gs^Ft       , Gs^Ft       , Gs^Ft       , Gs          , Gs          , Gs^Ft       , Gs          , Gs          , Gs          , Gs          , Gs          , Gs          , Gs          , Gs          , Gs          , Rrc         , Rrc         , Ch          , Rr          , Rr          , Rr^Vhc      , Rr          , Rr^Vhc      , Rr          , Rr          , Gg          , Wwg^Bsb/    , Rrc         , Gs          , Gs          , Gs^Vht      , Gs          , Gs          , Gs          , Gs          , Gs          , Hh          , Hh          , Hh          , Hh          
Gs^Ft       , Gs^Ft       , Gs^Ft       , Gs^Ft       , Gs^Ft       , Gs^Ft       , Gs^Ft       , Gs          , Gs^Ft       , Gs          , Gs          , Gs          , Gs          , Gs          , Gs          , Gs          , Gs          , Gs          , Rr          , Rr          , Gs          , Ch          , Ch          , Rr^Vhc      , Ch          , Ch          , Gg          , Rr          , Wwg         , Gg          , Gs          , Gs          , Gs          , Gs          , Gs          , Gs          , Hh          , Hh          , Hh          , Hh          , Mm          , Mm          
Gs^Ft       , Gs^Ft       , Gs^Ft       , Gs^Ft       , Gs^Ft       , Gs^Ft       , Gs^Ft       , Gs^Ft       , Gs^Ft       , Gs^Ft       , Gs          , Gs          , Gs          , Gs          , Gs          , Gs          , Rr          , Rr          , Gg          , Gs          , Gg          , Gg          , Gg          , Ch          , Gg          , Gg          , Wwg         , Wwg         , Gg          , Gg          , Gs          , Gs          , Gs          , Gs          , Hh          , Gs          , Hh          , Hh          , Mm          , Mm          , Mm          , Mm          
Gs^Ft       , Gs^Ft       , Gs^Vht      , Gs^Ft       , Gs^Ft       , Gs^Ft       , Gs^Ft       , Gs^Ft       , Gs^Ft       , Gs^Ft       , Gs^Ft       , Gs          , Gs          , Gs          , Rr          , Rr          , Wwg         , Wwg         , Wwg         , Gg^Vht      , Wwg         , Wwg         , Wwg         , Wwg         , Wwg         , Wwg         , Gg          , Gg          , Gs          , Gs          , Gs          , Gs          , Hh          , Hh          , Hh          , Hh          , Mm          , Mm          , Mm          , Mm          , Mm          , Mm          
Gs^Ft       , Gs^Ft       , Gs^Ft       , Gs^Ft       , Gs^Ft       , Gs^Ft       , Gs^Ft       , Gs^Ft       , Gs^Ft       , Gs^Ft       , Gs^Ft       , Gs          , Rr          , Rr          , Wwg         , Wwg         , Hh          , Hh          , Hh          , Wwg         , Hh          , Gg          , Gg          , Gg          , Gg          , Gg          , Gs          , Gs          , Gs          , Gs          , Gs          , Hh          , Hh          , Hh          , Mm          , Mm          , Mm          , Mm          , Mm          , Mm          , Hh          , Mm          
Gs^Ft       , Gs^Ft       , Gs^Ft       , Gs^Ft       , Gs^Ft       , Gs^Ft       , Gs^Ft       , Gs^Ft       , Gs          , Gs^Ft       , Rr          , Rr          , Wwg         , Wwg         , Gg^Ft       , Hh          , Mm          , Mm          , Hh          , Hh          , Mm          , Hh          , Hh          , Gg          , Gs          , Gs          , Gs          , Gs          , Hh          , Gs          , Re          , Hh          , Hh          , Hh          , Hh          , Hh          , Hh          , Hh^Vhh      , Hh          , Hh          , Hh          , Hh          
Gs^Ft       , Gs^Ft       , Gs^Ft       , Gs^Ft       , Gs^Ft       , Gs^Ft       , Gs^Ft       , Gs          , Rr          , Rr          , Wwg         , Wwg         , Hh          , Hh          , Hh          , Hh          , Hh          , Hh          , Hh          , Mm          , Hh          , Mm          , Mm          , Hh          , Hh          , Gs          , Hh          , Hh          , Mm          , Hh          , Hh          , Re          , Re          , Hh          , Hh          , Hh          , Hh          , Hh          , Hh          , Hh          , Hh          , Hh          
Gs^Ft       , Gs^Ft       , Gs^Ft       , Gs^Ft       , Gs^Ft       , Gs^Ft       , Rr          , Rr          , Wwg         , Wwg         , Gg^Ft       , Gg^Ft       , Hh          , Mm          , Hh          , Hh          , Mm          , Hh^Vhh      , Mm          , Hh          , Hh          , Hh          , Hh          , Mm          , Hh          , Hh^Vhh      , Hh          , Mm          , Hh          , Hh          , Hh          , Hh          , Hh          , Re          , Re          , Hh          , Re          , Re          , Re          , Hh          , Ce          , Hh          
Gs          , Gs^Ft       , Gs          , Gs^Ft       , Rr          , Rr          , Wwg         , Wwg         , Gg^Ft       , Gg^Ft       , Gs^Ft       , Gs^Ft       , Hh          , Hh          , Hh          , Hh^Vhh      , Mm          , Mm          , Mm^Vhh      , Mm          , Mm          , Hh          , Hh          , Hh          , Hh          , Hh          , Hh          , Hh          , Mm          , Hh          , Hh          , Mm          , Mm          , Hh          , Hh          , Re          , Hh          , Hh          , Ce          , Ce          , Ce          , Hh          
Gs          , Gs          , Rr          , Rr          , Wwg         , Wwg         , Gg^Ft       , Gg^Ft       , Hh          , Hh          , Hh          , Hh          , Hh          , Hh          , Mm          , Mm          , Mm          , Mm          , Hh          , Mm          , Mm          , Mm          , Hh          , Hh          , Mm          , Mm          , Mm          , Mm          , Hh          , Hh          , Hh          , Hh^Vhh      , Hh          , Hh          , Hh          , Hh          , Ce          , Ce          , Ce          , 3 Ke        , Hh          , Hh          
Rr          , Rr          , Wwg         , Wwg         , Gg^Ft       , Gg^Ft       , Gs^Ft       , Hh          , Hh          , Hh          , Hh          , Hh          , Hh          , Hh          , Hh          , Mm          , Gs          , Hh          , Hh          , Hh          , Hh          , Hh          , Hh          , Mm          , Hh          , Mm          , Hh          , Mm          , Mm          , Hh          , Hh          , Hh          , Hh          , Hh          , Hh          , Hh          , Hh          , Hh          , Hh          , Hh          , Hh          , Hh          
