border_size=1
usage=map

Rb^Ft       , Gs          , Gs^Edpp     , Gs^Ft       , Gs^Edpp     , Gs^Ft       , Gs^Ft       , Gs^Ft       , Gs^Ft       , Gs^Ft       , Gs^Ft       , Gs^Ft       , Hh          , Rr          , Rr          , Rr          , Gs          , Gs          , Gs          , Gs          , Gs          , Gs          , Gs          , Gs^Es       , Gs^Ft       , Hh          , Hh          , Hh          , Hh          , Hh          , Hh          , Hh          , Hh          
Rb^Ft       , Ss          , Gs^Edpp     , Gs^Edpp     , Gs          , Gs^Edpp     , Gs^Vht      , Gs^Ft       , Gs          , Gs^Ft       , Ce          , Gs^Ft       , Gs^Ft       , Hh          , Rr          , Rr          , Gs          , Gs          , Gs^Edp      , Gs          , Gs          , Gs^Efm      , Gs          , Gs^Es       , Gs^Ft       , Hh          , Hh          , Hh          , Hh          , Hh          , Hh          , Hh          , Hh          
Gs^Ft       , Gs^Ft       , Gs^Edpp     , Gs^Em       , Gs          , Gs          , Gs          , Gs          , Ss          , Ce          , 2 Ke        , Ce          , Gs^Ft       , Hh          , Rr          , Rr          , Gs          , Gs          , Gs          , Gs^Vht      , Gs          , Gs          , Gs^Es       , Gs^Ft       , Gs^Ft       , Hh          , Hh          , Hh          , Gs^Ft       , Gs^Ft       , Hh          , Hh          , Hh          
Gs^Ft       , Gs^Ft       , Ss          , Gs          , Gs^Vht      , Gs          , Gs          , Gs^Ft       , Ss          , Ce          , Ce          , Ce          , Hh          , Hh          , Rr          , Rr          , Gs          , Gs^Edp      , Gs          , Gs          , Gs          , Gs^Es       , Re^Es       , Gs^Ft       , Hh          , Hh^Vhh      , Hh          , Gs^Ft       , Gs^Ft       , Gs^Ft       , Gs^Ft       , Hh          , Hh          
Gs^Ft       , Ss          , Ss          , Ss          , Gs^Ft       , Gs          , Gs          , Gs          , Gs          , Gs^Ft       , Gs          , Gs          , Hh          , Gs^Vht      , Rr          , Rr          , Gs          , Gs^Efm      , Gs^Edp      , Gs^Edp      , Gs^Es       , Hh          , Gs^Ft       , Gs^Ft       , Hh          , Hh          , Gs^Ft       , Gs^Ft       , Re^Es       , Gs^Ft       , Gs^Ft       , Hh          , Hh          
Gs^Ft       , Rb^Ft       , Gs^Ft       , Ss          , Ss          , Ss          , Ss          , Gs          , Gs          , Gs          , Gs          , Gs          , Gs          , Hh          , Rr          , Rr          , Gs          , Gs^Edp      , Gs^Edp      , Gs^Edp      , Gs^Ft       , Hh          , Hh          , Hh          , Hh          , Hh          , Gs^Es       , Gs^Es       , Gs          , Gs^Ft       , Gs^Ft       , Hh          , Hh          
Rb^Ft       , Rb^Ft       , Rb^Ft       , Rb^Ft       , Rb^Ft       , Rb^Ft       , Ss          , Ss          , Gs^Vht      , Gs          , Gs^Efm      , Gs          , Gs          , Gs          , Rr          , Rr          , Gs          , Gs          , Gs^Edpp     , Gs^Es       , Gs^Ft       , Hh          , Gs^Ft       , Hh          , Gs^Es       , Gs^Es       , Gs^Es       , Gs^Es       , Re          , Gs^Es       , Gs^Ft       , Hh          , Hh          
Gs^Ft       , Rb^Ft       , Ss          , Gs^Ft       , Rb^Em       , Rb^Ft       , Rb^Em       , Ss          , Ss          , Gs^Edpp     , Gs^Edpp     , Gs^Edpp     , Hh          , Gs          , Rr          , Rr          , Gs          , Gs^Edp      , Gs^Es       , Gs^Es       , Gs^Ft       , Hh^Vhh      , Gs^Ft       , Gs^Ft       , Gs^Es       , Re          , Gs^Es       , Gs^Es       , Gs^Es       , Gs^Es       , Hh          , Hh          , Hh          
Gs^Ft       , Ss          , Ss          , Rb^Em       , Rb          , Rb          , Rb^Ft       , Ss          , Gs^Ft       , Gs^Ft       , Gs^Edp      , Hh          , Hh          , Gs          , Rr          , Rr          , Gs          , Gs^Edp      , Gs^Ft       , Gs^Ft       , Hh          , Hh          , Gs^Es       , Gs^Es       , Gs          , Gs          , Hh^Vhh      , Gs^Es       , Gs^Ft       , Gs^Ft       , Hh          , Hh          , Hh          
Rb^Ft       , Ss          , Rb^Ft       , Rb^Em       , Rb          , Rb^Em       , Gs^Ft       , Gs^Ft       , Gs^Ft       , Gs^Edpp     , Gs^Edp      , Gs^Edp      , Hh          , Gs^Ft       , Rr          , Rr          , Gs          , Gs^Ft       , Gs^Ft       , Hh          , Gs^Ft       , Gs^Ft       , Gs^Es       , Re          , Gs^Es       , Gs^Es       , Hh          , Gs^Ft       , Hh          , Gs^Ft       , Hh          , Gs^Ft       , Hh          
Rb^Ft       , Rb^Em       , Rb          , Rb          , Gs^Edpp     , Gs^Ft       , Gs^Ft       , Gs^Ft       , Gs^Ft       , Gs^Edp      , Gs^Es       , Hh          , Hh          , Hh          , Rr          , Rr          , Gs          , Gs^Es       , Hh^Es       , Hh          , Gs^Es       , Gs^Es       , Re          , Gs          , Hh          , Gs^Ft       , Hh          , Hh          , Hh          , Hh          , Gs^Ft       , Gs^Ft       , Hh          
Rb^Ft       , Rb^Ft       , Rb          , Rb^Em       , Gs^Ft       , Gs^Ft       , Ss          , Ss          , Ss          , Gs^Ft       , Gs^Edpp     , Gs^Edp      , Gs^Edp      , Gs          , Rr          , Rr          , Gs^Vht      , Gs^Es       , Re^Es       , Gs^Es       , Gs          , Gs          , Gs          , Gs^Es       , Gs^Ft       , Hh          , Hh          , Hh          , Hh          , Hh          , Hh^Vhh      , Gs^Ft       , Hh          
Ss          , Rb^Ft       , Rb          , Rb^Ft       , Gs^Ft       , Ss          , Ss          , Gs^Ft       , Rb^Ft       , Ss          , Hh          , Gs^Edpp     , Hh          , Gs          , Rr          , Rr          , Gs^Ft       , Hh          , Hh          , Hh          , Gs^Ft       , Gs          , Gs          , Gs^Ft       , Hh          , Hh^Vhh      , Gs^Edpp     , Gs^Ft       , Gs^Edpp     , Gs^Ft       , Gs^Es       , Gs^Ft       , Hh          
Rb^Ft       , Ss          , Rb          , Rb^Ft       , Ss          , Ss          , Ss          , Gs^Ft       , Ss          , Rb^Ft       , Hh          , Hh          , Ss          , Ss          , Rr          , Rr          , Hh          , Hh          , Gs^Ft       , Hh          , Gs          , Gs          , Gs          , Gs^Ft       , Gs^Es       , Gs^Es       , Gs^Edpp     , Gs^Edpp     , Gs^Edpp     , Gs^Edpp     , Gs^Edpp     , Gs^Ft       , Gs^Ft       
Rb^Ft       , Rb^Em       , Rb          , Rb^Em       , Gs^Ft       , Gs^Ft       , Rb^Ft       , Ss          , Gs^Ft       , Ss          , Gs^Ft       , Hh          , Hh          , Ss          , Rr          , Rr          , Rr          , Gs^Ft       , Gs^Ft       , Gs^Ft       , Gs          , Gs^Efm      , Gs^Efm      , Gs          , Gs          , Gs^Es       , Gs^Edpp     , Gs^Edp      , Gs^Edpp     , Gs^Edp      , Gs^Edpp     , Gs^Es       , Gs          
Rb^Edpp     , Rb^Ft       , Rb          , Rb^Ft       , Gs^Ft       , Gs^Ft       , Rb^Ft       , Rb^Ft       , Rb^Ft       , Gs^Ft       , Gs^Edpp     , Gs^Edpp     , Gs          , Hh          , Hh          , Rr          , Rr          , Rr          , Rr          , Gs          , Gs          , Gs^Efm      , Gs          , Gs^Efm      , Gs          , Hh          , Gs          , Gs^Esd      , Gs^Edpp     , Gs^Edpp     , Gs^Edp      , Gs^Edpp     , Gs          
Gs^Ft       , Rb^Em       , Rb          , Rb^Ft       , Gs^Ft       , Rb^Edpp     , Rb^Em       , Rb^Ft       , Rb          , Rb          , Gs^Edpp     , Gs          , Gs          , Gs          , Gs          , Gs          , Gs          , Rr          , Rr          , Rr          , Rr          , Gs          , Gs          , Gs          , Gs^Efm      , Gs          , Gs^Efm      , Gs          , Gs^Vht      , Gs^Edpp     , Gs          , Gs          , Gs          
Gs^Ft       , Gs^Ft       , Ss          , Rb^Em       , Rb          , Rb          , Rb^Gvs      , Rb^Gvs      , Gs^Ft       , Rb^Em       , Gs^Ft       , Gs^Edpp     , Gs^Edpp     , Gs          , Gs^Efm      , Gs          , Gs          , Gs          , Gs^Vht      , Rr          , Rr          , Rr          , Ce          , Gs          , Gs          , Gs          , Gs          , Gs          , Gs          , Gs          , Gs^Efm      , Gs          , Gs          
Gs^Ft       , Ss          , Ss          , Rb^Ft       , Rb^Ft       , Rb^Ft       , Gs^Ft       , Ss^Vhs      , Ss          , Ss          , Gs^Ft       , Gs^Ft       , Gs^Ft       , Gs^Edpp     , Gs          , Gs          , Gs          , Gs          , Gs          , Gs          , Gs          , Ce          , 1 Ke        , Ce          , Rr          , Gs          , Gs          , Gs          , Gs          , Gs          , Gs^Es       , Gs          , Gs          
Gs^Ft       , Ss          , Ss          , Rb^Ft       , Rb^Ft       , Rb^Ft       , Rb^Ft       , Gs^Ft       , Ss          , Ss          , Gs^Ft       , Gs^Ft       , Gs^Ft       , Gs^Ft       , Gs^Ft       , Gs^Edpp     , Gs^Edpp     , Gs          , Gs          , Gs          , Gs^Efm      , Ce          , Ce          , Ce          , Rr          , Rr          , Rr          , Gs          , Gs^Es       , Hh          , Hh          , Hh          , Hh          
Ss          , Ss          , Gs^Ft       , Gs^Ft       , Gs^Ft       , Rb^Ft       , Rb^Em       , Gs^Ft       , Ss          , Rb^Em       , Rb^Ft       , Rb          , Rb          , Gs^Ft       , Gs^Ft       , Gs^Ft       , Gs^Ft       , Gs^Edpp     , Gs^Edpp     , Gs          , Gs          , Gs          , Hh          , Gs          , Gs          , Rr          , Rr          , Rr          , Rr          , Hh          , Hh          , Hh          , Hh          
Ss          , Ss          , Gs^Ft       , Gs^Ft       , Gs^Ft       , Rb^Ft       , Rb          , Gs^Ft       , Ss          , Rb^Ft       , Gs^Ft       , Rb^Ft       , Gs^Ft       , Rb          , Gs^Ft       , Gs^Ft       , Gs^Edpp     , Gs^Edpp     , Gs^Edpp     , Gs^Edpp     , Hh          , Hh          , Hh          , Hh          , Hh          , Gs          , Gs          , Rr          , Rr          , Rr          , Rr          , Hh          , Hh          
