border_size=1
usage=map

Xu          , Xu          , Xu          , Xu          , Xu          , Xu          , Xu          , Xu          , Xu          , Xu          , Xu          , Xu          , Xu          , Xu          , Xu          , Xu          , Xu          , Xu          , Xu          , Xu          , Xu          , Xu          , Xu          , Xu          , Xu          , Xu          , Xu          , Xu          , Xu          , Xu          , Xu          , Xu          , Xu          , Xu          , Xu          , Xu          , Xu          
Xu          , Xu          , Xu          , Xu          , Xu          , Xu          , Xu          , Xu          , Xu          , Xu          , Xu          , Xu          , Xu          , Xu          , Xu          , Xu          , Xu          , Xu          , Xu          , Xu          , Xu          , Xu          , Xu          , Xu          , Xu          , Xu          , Xu          , Xu          , Xu          , Xu          , Xu          , Xu          , Xu          , Xu          , Xu          , Xu          , Wwf         
Xu          , Xu          , Xu          , Xu          , Xu          , Xu          , Xu          , Xu          , Xu          , Xu          , Uh          , Xu          , Xu          , Xu          , Xu          , Xu          , Xu          , Xu          , Xu          , Xu          , Xu          , Xu          , Uh          , Uh          , Uh          , Xu          , Xu          , Xu          , Xu          , Xu          , Xu          , Xu          , Xu          , Xu          , Xu          , Xu          , Wwf         
Xu          , Xu          , Xu          , Xu          , Uh          , Uh          , Uh          , Uh          , Uh          , Uh          , Uu          , Uh          , Xu          , Xu          , Xu          , Xu          , Xu          , Xu          , Xu          , Xu          , Xu          , Xu          , Uh          , Uh          , Uh          , Uh          , Xu          , Xu          , Xu          , Xu          , Uu^Vud      , Xu          , Xu          , Xu          , Xu          , Xu          , Wwf         
Xu          , Xu          , Xu          , Xu          , Uh          , Uh          , Uh          , Uh          , Uh          , Uu          , Uu^Vud      , Uu          , Uu          , Xu          , Xu          , Xu          , Xu          , Xu          , Xu          , Xu          , Uh          , Uh          , Uu^Vu       , Uh          , Uh          , Xu          , Xu          , Xu          , Wwf         , Wwf         , Wwf         , Xu          , Xu          , Xu          , Xu          , Xu          , Wwf         
Xu          , Xu          , Xu          , Xu          , Uh          , Uh          , Uu          , Uh          , Cud         , Uu          , Uu          , Uu          , Uu          , Uh          , Xu          , Xu          , Xu          , Xu          , Uu          , Uu          , Ur          , Uu          , Ur          , Uu          , Uu          , Xu          , Wwf         , Wwf         , Ce          , Ce          , Ce          , Wwf         , Wwf         , Xu          , Uu          , Xu          , Wwf         
Xu          , Xu          , Xu          , Uh          , Uh          , Uh          , Uu          , Cud         , 3 Kud       , Cud         , Uu          , Uu          , Ur          , Uu^Vud      , Ur          , Xu          , Uu          , Ur          , Ur          , Ur          , Uu          , Ur          , Ur          , Ur          , Wwf         , Wwf         , Uh          , Uh          , Ce          , 2 Ke        , Ce          , Uh          , Xu          , Wwf         , Wwf         , Wwf         , Wwf         
Xu          , Xu          , Xu          , Uh          , Uh          , Uh          , Uu          , Cud         , Cud         , Cud         , Ur          , Ur          , Uu          , Ur          , Ur          , Ur          , Ur          , Ur          , Ur          , Ur          , Ur          , Ur          , Uu          , Wwf         , Uu          , Ur          , Uh          , Uh          , Uu          , Ce          , Uu^Vud      , Uh          , Uh          , Uu^Vu       , Xu          , Xu          , Uu          
Xu          , Xu          , Xu          , Uh          , Uh          , Uu          , Uu          , Cud         , Ur          , Ur          , Uu          , Uu          , Xu          , Xu          , Xu          , Uh          , Xu          , Uu^Vud      , Uu          , Ur          , Uu          , Ur          , Wwf         , Wwf         , Uu          , Ur          , Ur          , Uu          , Uu          , Uu          , Uh          , Uh          , Xu          , Xu          , Xu          , Xu          , Uu          
Xu          , Xu          , Xu          , Uh          , Uh          , Uu          , Uu          , Ur          , Ur          , Ur          , Uu          , Uu          , Uh          , Xu          , Uu^Uf       , Xu          , Uu^Uf       , Xu          , Uu^Em       , Uu          , Uu          , Wwf         , Uu          , Ur          , Uu^Vud      , Ur          , Ur          , Uu          , Uu          , Uu          , Xu          , Xu          , Xu          , Xu          , Xu          , Xu          , Uu          
Xu          , Xu          , Xu          , Uh          , Uu          , Uu          , Ur          , Ur          , Ur          , Ur          , Ur          , Uu          , Uu^Ii       , Xu          , Wwg^Ii      , Wwg^Ii      , Wwg^Ii      , Wwf^Ii      , Wwf^Ii      , Uu^Em       , Wwf         , Wwf         , Xu          , Ur          , Uu          , Uu          , Ur          , Uu          , Xu          , Ur          , Ur          , Xu          , Xu          , Xu          , Xu          , Xu          , Uu          
Xu          , Xu          , Xu          , Xu          , Ur          , Ur          , Uu          , Uu^Vud      , Uu          , Uu          , Uu          , Ur          , Ur^Ii       , Uu^Ii       , Wwg^Ii      , Wwg^Ii      , Wog^Ii      , Wog^Ii      , Wog^Ii      , Wwf^Ii      , Uu^Em       , Ur          , Xu          , Xu          , Uu          , Uu          , Ur          , Uu          , Xu          , Xu          , Ur          , Xu          , Xu          , Xu          , Xu          , Xu          , Xu          
Xu          , Xu          , Xu          , Ur          , Ur          , Uu          , Xu          , Xu          , Xu          , Uh          , Xu          , Uu          , Xu          , Wwf^Ii      , Wwg^Ii      , Wog^Ii      , Wog^Ii      , Wog^Ii      , Wog^Ii      , Xu          , Uu^Vu       , Ur          , Ur          , Ur          , Uh          , Uu          , Ur          , Uu          , Xu          , Xu          , Ur          , Xu          , Xu          , Xu          , Xu          , Xu          , Xu          
Xu          , Xu          , Xu          , Uu          , Ur          , Uu          , Xu          , Xu          , Xu          , Xu          , Xu          , Xu          , Uu^Uf       , Wwf^Ii      , Wwg^Ii      , Wog^Ii      , Wog^Ii      , Wog^Ii      , Wog^Ii      , Xu          , Xu          , Ur          , Ur          , Uh          , Xu          , Uu          , Ur          , Uh          , Xu          , Xu          , Ur          , Xu          , Wwf         , Xu          , Wwf         , Wwf         , Wwf         
Xu          , Xu          , Xu          , Uu          , Ur          , Uu          , Uu^Vud      , Xu          , Xu          , Xu          , Xu          , Xu          , Uu^Uf       , Wwf^Ii      , Wwg^Ii      , Wwg^Ii      , Wog^Ii      , Wog^Ii      , Wwg^Ii      , Xu          , Wwf         , Ur          , Uu          , Uh          , Uu^Uf       , Ur          , Uu          , Uu^Uf       , Xu          , Ur          , Wwf         , Wwf         , Xu          , Wwf         , Xu          , Xu          , Wwf         
Xu          , Xu          , Xu          , Ur          , Ur          , Ur          , Ur          , Ur          , Uu          , Uh          , Uh          , Xu          , Xu          , Wwf^Ii      , Wwf^Ii      , Wog^Ii      , Wwg^Ii      , Wwg^Ii      , Wwg^Ii      , Wwg^Ii      , Ur^Ii       , Wwf         , Wwf         , Wwf         , Wwf         , Wwf         , Wwf         , Wwf         , Wwf         , Wwf         , Xu          , Xu          , Xu          , Xu          , Xu          , Xu          , Wwf         
Xu          , Xu          , Xu          , Xu          , Xu          , Uu          , Uu          , Ur          , Ur          , Uu          , Ur          , Uh          , Ur          , Xu          , Xu          , Ur^Em       , Ur^Ii       , Wwg^Ii      , Wwg^Ii      , Ur^Em       , Ur^Ii       , Uu^Ii       , Uh          , Ur          , Ur          , Uu          , Ur          , Ur          , Uu          , Uu^Vud      , Xu          , Xu          , Xu          , Xu          , Xu          , Xu          , Wwf         
Xu          , Xu          , Xu          , Xu          , Xu          , Xu          , Uh          , Uh          , Uh          , Ur          , Ur          , Ur          , Uu          , Xu          , Xu          , Xu          , Uu          , Ur^Ii       , Wwg^Ii      , Ur^Ii       , Uu^Uf       , Uu^Uf       , Xu          , Ur          , Uu          , Uu          , Xu          , Ur          , Uu          , Xu          , Xu          , Xu          , Xu          , Xu          , Xu          , Xu          , Wwf         
Xu          , Xu          , Xu          , Xu          , Xu          , Xu          , Xu          , Uh          , Uu          , Ur          , Ur          , Uh          , Uu          , Uu          , Uu^Vu       , Uu          , Ur          , Ur          , Wwf         , Ur          , Xu          , Xu          , Uu          , Uu^Vud      , Uh          , Uh          , Xu          , Ur          , Uu          , Uh          , Uh          , Xu          , Xu          , Xu          , Xu          , Xu          , Wwf         
Xu          , Xu          , Xu          , Xu          , Xu          , Xu          , Xu          , Xu          , Xu          , Uu          , Uu          , Ur          , Ur          , Ur          , Ur          , Ur          , Uh          , Uu          , Wwf         , Ur          , Ur          , Uu          , Uu          , Uu          , Xu          , Xu          , Xu          , Ur          , Uu          , Uh          , Xu          , Xu          , Xu          , Xu          , Xu          , Xu          , Xu          
Xu          , Xu          , Xu          , Xu          , Xu          , Xu          , Xu          , Xu          , Xu          , Xu          , Xu          , Uu          , Xu          , Ur          , Uu          , Ur          , Ur          , Ur          , Wwf         , Uu          , Ur          , Ur          , Uu          , Uu          , Xu          , Xu          , Ur          , Ur          , Uu          , Uh          , Xu          , Xu          , Xu          , Xu          , Xu          , Xu          , Xu          
Xu          , Xu          , Xu          , Xu          , Xu          , Xu          , Xu          , Xu          , Xu          , Xu          , Xu          , Xu          , Xu          , Xu          , Uh          , Uu          , Uu          , Uu          , Wwf         , Wwf         , Uu          , Ur          , Ur          , Uu          , Uu          , Xu          , Ur          , Uu          , Xu          , Xu          , Xu          , Xu          , Xu          , Xu          , Xu          , Xu          , Xu          
Xu          , Xu          , Xu          , Xu          , Xu          , Xu          , Xu          , Xu          , Xu          , Xu          , Xu          , Xu          , Xu          , Xu          , Uh          , Uh          , Uh          , Uu          , Uu^Vud      , Wwf         , Ur          , Uu          , Ur          , Uu          , Uu          , Xu          , Ur          , Uu          , Xu          , Xu          , Xu          , Xu          , Xu          , Xu          , Xu          , Xu          , Xu          
Xu          , Xu          , Xu          , Xu          , Xu          , Xu          , Xu          , Xu          , Xu          , Xu          , Xu          , Xu          , Xu          , Xu          , Xu          , Uh          , Uh          , Uu          , Uu          , Wwf         , Ur          , Uu          , Ce          , Uu^Vud      , Ur          , Ur          , Uu          , Uu^Vud      , Xu          , Xu          , Xu          , Xu          , Xu          , Xu          , Xu          , Xu          , Xu          
Xu          , Xu          , Xu          , Xu          , Xu          , Xu          , Xu          , Xu          , Xu          , Xu          , Xu          , Xu          , Xu          , Xu          , Xu          , Uh          , Uh          , Uu          , Uu          , Wwf         , Uu          , Ce          , 1 Ke        , Ce          , Ur          , Uu          , Xu          , Xu          , Xu          , Xu          , Xu          , Xu          , Xu          , Xu          , Xu          , Xu          , Xu          
Xu          , Xu          , Xu          , Xu          , Xu          , Xu          , Xu          , Xu          , Xu          , Xu          , Xu          , Xu          , Xu          , Xu          , Xu          , Xu          , Xu          , Uh          , Uu          , Wwf         , Wwf         , Ce          , Ce          , Ce          , Uu          , Uu          , Xu          , Xu          , Xu          , Xu          , Xu          , Xu          , Xu          , Xu          , Xu          , Xu          , Xu          
Xu          , Xu          , Xu          , Xu          , Xu          , Xu          , Xu          , Xu          , Xu          , Xu          , Xu          , Xu          , Xu          , Xu          , Xu          , Xu          , Xu          , Uh          , Xu          , Uu          , Uu          , Wwf         , Wwf         , Ur          , Uu          , Uu          , Uu          , Xu          , Xu          , Xu          , Xu          , Xu          , Xu          , Xu          , Xu          , Xu          , Xu          
Xu          , Xu          , Xu          , Xu          , Xu          , Xu          , Xu          , Xu          , Xu          , Xu          , Xu          , Xu          , Xu          , Xu          , Xu          , Xu          , Xu          , Xu          , Xu          , Uu          , Uu          , Uu          , Wwf         , Wwf         , Wwf         , Uu          , Uu          , Xu          , Xu          , Xu          , Xu          , Xu          , Xu          , Xu          , Xu          , Xu          , Uue         
