border_size=1
usage=map

Dd          , Dd          , Dd          , Dd          , Dd          , Dd          , Dd          , Dd          , Dd          , Dd          , Dd          , Dd          , Dd          , Dd          , Dd          , Dd          , Dd          , Dd          , Dd          , Dd          , Dd          , Dd          , Dd          , Dd          , Dd          , Dd          , Dd          , Dd          , Dd          , Dd          , Dd          , Rd          , Dd          , Dd          , Dd          , Dd          , Dd          , Dd          , Dd          , Dd          , Dd          , Dd          , Dd          , Dd          , Dd          , Dd          
Dd          , Dd          , Dd          , Dd          , Dd          , Dd          , Dd          , Dd          , Dd          , Dd          , Dd          , Dd          , Dd          , Dd          , Dd          , Dd          , Dd          , Dd          , Dd^Edpp     , Dd          , Dd^Edpp     , Dd          , Dd          , Dd^Edpp     , Dd          , Dd          , Dd          , Dd          , Dd          , Dd          , Dd          , Rd          , Dd          , Dd          , Dd          , Dd          , Dd^Edpp     , Dd          , Dd^Edpp     , Dd          , Dd^Edpp     , Dd          , Dd          , Dd          , Dd^Edpp     , Dd          
Dd          , Dd          , Dd          , Dd          , Dd          , Dd          , Dd          , Dd          , Hhd         , Dd          , Dd          , Dd          , Dd          , Dd          , Dd          , Dd^Edp      , Dd^Edpp     , Dd^Edpp     , Dd^Edp      , Dd^Edpp     , Re          , Dd^Edp      , Dd^Edp      , Dd          , Re          , Dd          , Gs^Edpp     , Dd^Edpp     , Dd^Edpp     , Dd          , Dd          , Dd          , Re          , Dd          , Gs^Edpp     , Re          , Gs^Edpp     , Dd^Edp      , Gs^Edp      , Dd          , Gs^Edpp     , Dd^Edpp     , Gs^Edpp     , Dd^Edpp     , Gs^Edpp     , Re          
Hhd         , Hhd         , Hhd         , Hhd         , Hhd         , Hhd         , Hhd         , Hhd         , Hhd         , Hhd         , Hhd         , Dd          , Re          , Dd          , Hhd         , Dd^Edpp     , Gs^Edp      , Gs^Edp      , Gs^Edpp     , Gs^Edp      , Gs^Edp      , Gs^Edp      , Gs^Edp      , Gs^Edpp     , Gs^Edpp     , Gs^Edpp     , Gs^Edpp     , Gs^Edpp     , Gs          , Gs          , Chr         , Gs          , Chr         , Gs^Edpp     , Gs          , Gs^Edp      , Gs          , Gs^Edp      , Gs^Edp      , Gs^Edp      , Gs^Edpp     , Gs^Edpp     , Gs^Edpp     , Gs^Edpp     , Gs          , Gs          
Hhd         , Hhd         , Hhd         , Md          , Md          , Hhd         , Hhd         , Hhd         , Hhd         , Hhd         , Hhd         , Hhd         , Hhd         , Hhd         , Hhd         , Hhd         , Hhd         , Gs^Edpp     , Gs^Edpp     , Gs^Edp      , Gs          , Gs          , Gs          , Gs^Edpp     , Gs          , Gs          , Gs          , Gs          , Gs          , Gs          , Gs          , Gs          , Gs          , Gs          , Gs          , Gs          , Gs          , Gs          , Gs          , Gs          , Gs^Edpp     , Gs^Edpp     , Gs          , Gs          , Gs          , Gs          
Hhd         , Hhd         , Md          , Md          , Hhd         , Hhd         , Md          , Md          , Hhd         , Hhd         , Hhd         , Hhd         , Hhd         , Hhd         , Re          , Re          , Gs          , Hhd         , Gs          , Gs          , Gs          , Gs          , Gs          , Gs          , Gs          , Gs          , Gs          , Gs          , Gs          , Gs          , Gs          , Rp          , Gs          , Gs          , Gs          , Gs          , Gs          , Gs          , Gs          , Gs          , Gs          , Gs          , Gs          , Gs          , Gs          , Gs          
Hhd         , Hhd         , Hhd         , Hhd         , Hhd         , Md          , Md          , Hhd         , Hhd         , Qxu         , Hhd         , Md          , Hhd         , Re          , Re          , Gs          , Gs          , Gs          , Gs          , Gs^Vht      , Gs          , Gs          , Gs^Edp      , Gs          , Gs^Edpp     , Gs          , Gs          , Hhd         , Hhd         , Gs          , Gs          , Rp          , Rp          , Gs          , Gs          , Gs^Es       , Gs^Vht      , Gs          , Gs          , Gs          , Gs          , Gs          , Gs          , Gs          , Gs          , Gs          
Re          , Re          , Gs          , Hhd         , Hhd         , Hhd         , Hhd         , Hhd         , Hhd         , Hhd         , Md          , Md          , Hhd         , Hhd         , Re          , Gs          , Gs          , Gs          , Gs          , Gs          , Gs^Edp      , Gs^Edp      , Gs^Edp      , Gs^Edp      , Gs^Edp      , Gs          , Gs          , Gs^Edpp     , Hhd         , Hhd^Vht     , Re          , Gs          , Gs          , Gs          , Gs          , Gs          , Gs          , Gs          , Gs^Edpp     , Hhd         , Hhd         , Gs^Edpp     , Gs          , Gs          , Gs^Fdw      , Gs^Fdw      
Gs          , Gs^Vht      , Gs          , Gs          , Gs          , Hhd         , Ce          , Hhd         , Hhd         , Hhd         , Hhd         , Hhd         , Hhd^Vhr     , Hhd         , Hhd         , Gs          , Gs          , Gs          , Gs          , Gs          , Gs^Edpp     , Gs^Ft       , Gs^Edpp     , Gs^Edpp     , Gs          , Gs          , Gs          , Gs          , Hhd         , Hhd         , Hhd         , Gs          , Gs          , Gs          , Gs          , Gs          , Gs          , Gs          , Gs^Edpp     , Gs          , Hhd         , Gs^Edpp     , Gs^Fdw      , Hhd         , Hhd^Fdw     , Gs^Fdw      
Gs          , Gs          , Gs          , Gs          , Gs          , Ce          , 1 Ke        , Ce          , Hhd         , Hhd         , Re          , Hhd         , Hhd         , Re          , Gs          , Hhd         , Hhd         , Gs          , Gs          , Gs          , Gs          , Gs^Edpp     , Gs          , Gs          , Gs          , Gs          , Gs          , Gs          , Gs          , Hhd         , Hhd         , Hhd         , Re          , Gs          , Rp          , Gs          , Gs          , Gs          , Gs          , Gs          , Gs^Edpp     , Hhd         , Hhd         , Hhd         , Hhd^Fdw     , Hhd^Fdw     
Gs          , Gs          , Gs          , Gs          , Gs          , Re          , Ce          , Ce          , Hhd         , Gs          , Gs          , Hhd         , Gs          , Gs          , Gs          , Gs          , Gs          , Gs          , Gs          , Re          , Gs          , Gs          , Gs          , Gs          , Gs          , Gs          , Gs^Ft       , Gs          , Gs          , Re          , Hhd         , Hhd         , Gs          , Gs          , Gs          , Rp          , Gs          , Gs          , Gs          , Gs          , Gs          , Gs^Edp      , Gs^Fdw      , Hhd^Fdw     , Hhd^Fdw     , Hhd^Fdw     
Gs          , Gs          , Gs          , Gs          , Gs^Vht      , Gs          , Hhd         , Hhd         , Gs          , Gs          , Gs          , Hhd         , Gs          , Gs          , Gs          , Gs          , Re          , Gs          , Gs          , Gs          , Gs          , Gs          , Gs          , Gs^Vht      , Gs          , Gs          , Gs^Ft       , Gs^Ft       , Gs          , Gs          , Gs          , Gs          , Gs          , Gs          , Gs          , Rp          , Gs          , Gs          , Gs          , Gs^Edp      , Gs          , Gs          , Gs^Fdw      , Hhd^Fdw     , Gs^Fdw      , Hhd^Fdw     
Re          , Gs          , Gs          , Gs          , Gs          , Gs          , Gs          , Gs          , Gs          , Gs          , Gs          , Gs          , Gs          , Gs          , Gs          , Gs          , Gs          , Gs          , Gs          , Gs          , Gs          , Gs          , Gs^Edp      , Gs^Edpp     , Gg          , Gg          , Gs^Ft       , Gs^Ft       , Gg          , Gs          , Gs^Ft       , Gs^Ft       , Gs          , Gs          , Gs^Vht      , Gs          , Gs          , Re          , Gs          , Gs          , Gs          , Gs          , Gs          , Gs^Fdw      , Gs^Fdw      , Gs^Fdw      
Hhd         , Re          , Re          , Gs          , Gs          , Gs          , Gs          , Gs          , Gs          , Gs          , Gs^Edp      , Gs          , Gs          , Gs          , Gs^Edpp     , Gs          , Gs          , Gs          , Gs          , Gs          , Gs^Ft       , Gs^Ft       , Gg          , Gg          , Wwf         , Gs^Ft       , Wwf         , Wwf         , Wwf         , Gg          , Gg          , Gs^Ft       , Gs          , Gs          , Gs          , Gs          , Gs          , Gs          , Gs          , Gs          , Ce          , Ce          , Ce          , Gs          , Gs          , Gs^Fdw      
Hhd         , Hhd         , Re          , Re          , Re          , Gs          , Gs          , Gs          , Gs^Edpp     , Gs^Vht      , Gs          , Gs          , Gs          , Gs          , Gs          , Gs^Vht      , Gs          , Gs          , Gs          , Gs          , Gg          , Gg          , Wwf         , Wwf         , Wwf         , Wwf         , Wwf         , Wwf         , Wwf         , Gg          , Gg          , Gs^Ft       , Gs          , Gs          , Gs          , Gs          , Gs          , Gs          , Gs          , Gs          , Ce          , 3 Ke        , Ce          , Gs^Vht      , Gs          , Gs          
Hhd         , Hhd         , Hhd         , Hhd         , Hhd         , Re          , Re          , Gs          , Gs          , Gs          , Gs          , Gs          , Gs^Edp      , Gs          , Gs          , Gs          , Re          , Gs          , Gs^Edp      , Gs^Ft       , Gg          , Wwf         , Wwf         , Wwf         , Wwg         , Wwg         , Wwg         , Wwf         , Wwf         , Wwf         , Gg          , Gs^Ft       , Gs          , Gs          , Gs          , Rp          , Gs          , Gs          , Gs          , Gs          , Gs          , Ce          , Gs          , Gs          , Gs          , Gs          
Hhd         , Hhd         , Hhd         , Hhd         , Hhd         , Re          , Hhd         , Re          , Re          , Gs          , Gs          , Gs          , Gs          , Gs          , Gs          , Gs          , Gs          , Gs          , Gs^Edp      , Gs^Ft       , Gg          , Wwf         , Wwf         , Wwg         , Wwg         , Wwg         , Wwg         , Wwg         , Wwg         , Wwf         , Gg          , Gs^Ft       , Gs^Edpp     , Gs          , Re          , Gs          , Gs          , Gs^Es       , Gs          , Gs          , Gs          , Gs          , Gs          , Gs          , Gs          , Gs          
Hhd         , Hhd         , Hhd         , Hhd         , Hhd         , Hhd         , Hhd         , Hhd         , Hhd         , Re          , Hhd         , Gs          , Gs          , Gs          , Gs          , Gs          , Gs          , Gs          , Gs          , Gs^Ft       , Gg          , Wwf         , Wwf         , Wwg         , Wwg         , Wog         , Wog         , Wwg         , Wwg         , Wwf         , Gg          , Gs^Edpp     , Gs          , Gs          , Gs          , Gs          , Gs          , Gs          , Gs^Vh       , Gs          , Gs          , Gs          , Gs          , Gs          , Rp          , Rp          
Hhd         , Hhd         , Hhd         , Hhd         , Hhd         , Hhd         , Hhd         , Hhd         , Hhd         , Hhd         , Hhd         , Hhd         , Hhd         , Gs          , Gs          , Gs          , Gs^Vht      , Gs          , Gs          , Gs          , Gg          , Wwf         , Wwf         , Wwg         , Wwg         , Wog         , Wwg         , Wwg         , Wwg         , Wwf         , Gg          , Gs          , Gs          , Gs          , Gs          , Gs          , Gs          , Gs          , Gs          , Gs          , Gs          , Gs          , Rp          , Gs          , Gs          , Gs          
Hhd         , Hhd         , Hhd         , Re          , Gs          , Gs          , Gs          , Hhd         , Gs          , Re          , Gs          , Hhd         , Gs          , Hhd         , Hhd         , Gs          , Gs          , Gs          , Gs          , Gs          , Gg          , Gg          , Wwf         , Wwg         , Wwg         , Wwg         , Wwg         , Wwg         , Wwf         , Wwf         , Gg          , Gs          , Gs          , Gs          , Gs          , Gs          , Gs          , Gs          , Gs          , Gs          , Gs          , Gs          , Gs          , Gs          , Gs          , Gs          
Re          , Re          , Gs          , Gs          , Gs          , Gs          , Gs          , Gs          , Gs          , Gs          , Gs          , Gs          , Gs^Edpp     , Gs          , Gs          , Gs          , Gs          , Gs          , Gs          , Gs^Ft       , Gg          , Gg          , Wwf         , Wwf         , Wwf         , Wwg         , Wwf         , Wwf         , Gg          , Gg          , Gs          , Gs          , Gs          , Gs^Vht      , Gs          , Rp          , Gs          , Gs          , Rp          , Gs          , Gs          , Gs          , Gs^Vh       , Gs          , Gs          , Gs          
Gs^Edpp     , Gs          , Gs          , Gs          , Gs          , Gs          , Gs          , Gs          , Gs          , Gs          , Gs^Edpp     , Gs^Edp      , Gs^Edpp     , Gs          , Gs          , Gs^Edpp     , Gs          , Gs          , Gs          , Gs          , Gs          , Gg          , Gg          , Wwf         , Gg          , Wwf         , Gg          , Gg          , Gs^Ft       , Gs^Ft       , Gs          , Gs          , Gs          , Gs          , Rp          , Rp          , Rp          , Rp          , Gs          , Gs          , Gs          , Gs          , Gs          , Gs          , Gs          , Gs          
Gs^Edpp     , Gs^Edpp     , Gs^Edpp     , Gs          , Gs          , Gs          , Gs          , Gs^Vht      , Gs          , Gs          , Gs^Edpp     , Gs^Ft       , Gs^Edpp     , Gs          , Gs^Edpp     , Gs^Edpp     , Gs          , Gs          , Gs          , Gs          , Gs          , Gs          , Gs^Ft       , Gs^Ft       , Gs^Ft       , Gg          , Gg          , Gs^Ft       , Gs          , Gs          , Gs          , Gs          , Gs          , Rp          , Gs          , Gs          , Gs          , Gs          , Gs          , Gs          , Gs          , Gs          , Gs          , Gs          , Gs          , Gs          
Gs^Edpp     , Gs^Edp      , Gs^Edp      , Gs^Edpp     , Gs^Edp      , Gs          , Gs          , Gs          , Gs          , Re          , Gs          , Gs^Edpp     , Gs          , Gs          , Gs          , Gs          , Gs          , Gs^Edpp     , Gs^Edpp     , Gs          , Gs          , Hhd         , Hhd         , Gs^Ft       , Gs^Edpp     , Gg          , Gs          , Gs          , Gs          , Gs          , Rp          , Gs          , Gs          , Gs          , Gs          , Re          , Re          , Gs          , Gs          , Gs^Edpp     , Gs          , Re          , Gs          , Gs          , Gs          , Gs          
Gs^Ft       , Gs^Edp      , Gs^Edp      , Gs^Edp      , Gs^Edp      , Gs^Edp      , Gs^Edp      , Gs          , Gs          , Gs          , Gs          , Gs          , Gs          , Hhd         , Hhd         , Re          , Hhd         , Gs          , Gs          , Gs          , Gs          , Gs          , Gs^Es       , Hhd         , Hhd         , Gs^Vht      , Gs          , Gs          , Gs          , Rp          , Gs          , Gs          , Re          , Gs          , Gs          , Gs          , Gs          , Gs          , Gs          , Gs          , Gs          , Gs          , Gs          , Gs          , Gs          , Gs          
Gs^Ft       , Gs^Ft       , Gs^Edp      , Gs^Edpp     , Gs^Edp      , Gs^Edp      , Gs^Edp      , Gs          , Gs          , Gs          , Gs          , Gs          , Gs          , Hhd         , Hhd         , Hhd         , Hhd         , Re          , Gs          , Gs          , Gs          , Gs          , Gs          , Gs          , Gs          , Gs          , Gs          , Gs          , Gs          , Gs          , Gs          , Gs          , Gs          , Gs          , Gs          , Gs          , Gs          , Re          , Gs^Vh       , Gs          , Re          , Gs          , Gs          , Re          , Gs          , Gs          
Gs^Ft       , Gs^Ft       , Gs^Edp      , Gs^Edpp     , Gs^Edpp     , Gs^Edpp     , Gs^Edpp     , Gs          , Gs          , Gs^Vht      , Gs          , Gs          , Gs          , Hhd         , Hhd         , Hhd         , Hhd^Vht     , Hhd         , Hhd         , Gs          , Gs          , Gs          , Gs          , Gs          , Re          , Gs          , Gs          , Rp          , Gs          , Gs          , Gs          , Gs          , Gs          , Gs          , Re          , Gs          , Gs          , Gs          , Gs          , Re          , Gs          , Gs          , Gs          , Gs^Edpp     , Gs          , Gs          
Gs^Ft       , Gs^Edp      , Gs^Ft       , Gs^Ft       , Gs^Edpp     , Gs^Edpp     , Gs^Edp      , Gs^Edpp     , Gs^Edpp     , Gs          , Gs          , Gs          , Gs          , Gs          , Gs          , Gs^Es       , Gs          , Hhd         , Hhd         , Hhd         , Re          , Gs          , Gs          , Gs          , Gs          , Gs          , Gs          , Gs          , Gs          , Gs          , Gs          , Gs^Vh       , Gs          , Gs          , Re          , Gs          , Gs          , Gs          , Re          , Re          , Gs          , Re          , Re          , Gs          , Gs          , Gs          
Gs^Ft       , Gs^Ft       , Gs^Ft       , Gs^Ft       , Gs^Ft       , Gs^Edpp     , Gs^Edp      , Gs^Edpp     , Gs^Edp      , Gs^Edpp     , Gs^Edpp     , Gs          , Gs          , Gs          , Gs          , Gs          , Gs          , Gs          , Gs          , Hhd         , Gs          , Gs          , Gs          , Gs          , Gs          , Gs          , Rp          , Gs          , Gs          , Gs          , Gs          , Gs          , Gs          , Gs          , Gs          , Re          , Gs          , Gs          , Gs          , Gs          , Re          , Gs          , Re          , Gs          , Gs          , Gs          
Gs^Ft       , Gs^Ft       , Gs^Ft       , Gs^Ft       , Gs^Ft       , Gs^Ft       , Gs^Edp      , Gs^Edpp     , Gs^Edp      , Gs^Edp      , Gs^Edp      , Gs^Edpp     , Gs^Edpp     , Gs          , Gs          , Gs          , Gs          , Gs          , Gs          , Gs          , Gs          , Gs          , Gs          , Re          , Gs          , Gs^Vht      , Gs          , Gs          , Gs          , Gs          , Gs          , Gs          , Gs          , Gs          , Gs          , Gs          , Re          , Gs          , Re          , Re          , Gs          , Gs          , Re          , Gs          , Gs          , Gs          
Gs^Ft       , Gs^Ft       , Gs^Ft       , Gs^Ft       , Gs^Ft       , Gs^Ft       , Gs^Ft       , Gs^Ft       , Gs^Ft       , Gs^Edpp     , Gs^Edp      , Gs^Edpp     , Gs^Edpp     , Gs          , Gs^Edpp     , Gs          , Gs          , Gs          , Gs          , Gs          , Gs          , Gs          , Gs          , Gs          , Gs          , Gs          , Gs          , Gs          , Gs          , Gs          , Gs          , Gs          , Gs          , Gs          , Gs^Vh       , Gs          , Gs          , Gs          , Re          , Re          , Gs          , Gs^Vh       , Gs          , Re          , Gs          , Gs          
Gs^Ft       , Gs^Ft       , Gs^Ft       , Gs^Ft       , Gs^Ft       , Gs^Ft       , Gs^Ft       , Gs^Ft       , Gs^Ft       , Gs^Ft       , Gs^Ft       , Gs^Edpp     , Gs^Edpp     , Gs^Edp      , Gs^Edpp     , Gs          , Gs          , Gs          , Gs          , Gs^Vht      , Re          , Re          , Gs          , Gs          , Gs          , Gs          , Rp          , Gs          , Gs          , Gs          , Chr         , Gs          , Gs          , Gs          , Gs          , Gs          , Gs          , Gs          , Gs          , Gs          , Gs          , Gs          , Re          , Gs          , Gs          , Gs          
Gs^Ft       , Gs^Ft       , Gs^Ft       , Gs^Ft       , Gs^Ft       , Gs^Ft       , Gs^Ft       , Gs^Ft       , Gs^Ft       , Gs^Ft       , Gs^Ft       , Gs^Ft       , Gs^Edp      , Gs^Edpp     , Gs^Edp      , Gs^Edpp     , Gs^Edpp     , Gs          , Gs          , Gs          , Gs          , Re          , Gs          , Gs          , Gs          , Gs          , Rp          , Gs          , Chr         , Chr         , Rr          , 2 Khr       , Rp          , Gs          , Gs          , Gs          , Gs          , Gs          , Gs          , Gs          , Gs          , Gs          , Gs          , Gs          , Gs          , Gs          
Gs^Ft       , Gs^Ft       , Gs^Ft       , Gs^Ft       , Gs^Ft       , Gs^Ft       , Gs^Ft       , Gs^Ft       , Gs^Ft       , Gs^Ft       , Gs^Ft       , Gs^Ft       , Gs^Edp      , Gs^Edpp     , Gs^Ft       , Gs^Edp      , Gs^Edp      , Gs          , Gs          , Gs          , Gs          , Gs          , Gs          , Gs          , Gs          , Gs          , Rp          , Chr         , Rr          , Rr          , Rr          , Rp          , Rp          , Gs          , Gs          , Gs          , Gs          , Gs^Edpp     , Gs          , Gs          , Gs          , Gs          , Gs          , Gs          , Gs          , Gs          
Gs^Ft       , Gs^Ft       , Gs^Ft       , Gs^Ft       , Gs^Ft       , Gs^Ft       , Gs^Ft       , Gs^Ft       , Gs^Ft       , Gs^Ft       , Gs^Ft       , Gs^Ft       , Gs^Ft       , Gs^Ft       , Gs^Ft       , Gs^Edp      , Gs^Edpp     , Gs^Edpp     , Gs          , Gs          , Gs          , Gs          , Gs          , Gs          , Gs          , Gs          , Rp          , Chr         , Rr          , Rr          , Rp          , Rp          , Gs          , Gs          , Gs          , Gs          , Gs          , Gs          , Gs          , Gs          , Gs          , Gs          , Gs          , Gs          , Gs          , Gs          
