border_size=1
usage=map

Hh          , Hh          , Hh          , Hh          , Hh          , Mm          , Mm          , Mm          , Mm          , Ww          , Ww          , Wo          , Wo          , Wo          , Ww          , Hh          , Mm          , Mm          , Hh          , Hh          , Gs^Ft       , Gs^Ft       , Gs^Ft       , Gs^Ft       , Gs^Ft       , Gs^Ft       , Gs^Ft       , Gs^Ft       , Gs^Ft       , Gs^Ft       , Gs^Ft       , Gs^Ft       , Gs^Ft       , Gs^Ft       , Gs^Ft       , Gs^Ft       , Gs^Ft       , Gs^Ft       , Gs^Ft       , Gs^Ft       , Gs^Ft       , Gs^Ft       , Gs^Ft       , Gs^Edpp     , Gs^Edpp     , Gs^Edpp     , Gs^Edpp     , Gs^Edpp     , Gs^Edpp     , Gs          
Gs^Ft       , Gs^Ft       , Gs^Ft       , Gs^Ft       , Gs^Ft       , Hh          , Hh          , Mm          , Mm          , Hh          , Ww          , Wo          , Wo          , Wo          , Ww          , Hh          , Hh          , Mm          , Hh          , Gs^Ft       , Gs^Ft       , Gs^Ft       , Gs^Ft       , Gs^Ft       , Gs^Ft       , Gs^Ft       , Gs^Ft       , Gs^Ft       , Gs^Ft       , Hh          , Gs^Ft       , Gs^Ft       , Gs^Ft       , Gs^Ft       , Gs^Ft       , Gs^Ft       , Gs^Ft       , Gs^Ft       , Gs^Ft       , Gs^Ft       , Gs^Ft       , Gs^Ft       , Gs^Edpp     , Gs^Edpp     , Gs^Edpp     , Gs^Edpp     , Gs^Edpp     , Gs^Edpp     , Gs^Edpp     , Gs^Edpp     
Gs          , Gs          , Gs          , Gs^Ft       , Ss          , Gs^Ft       , Hh          , Hh          , Hh          , Hh          , Hh          , Ww          , Ww          , Wo          , Wo          , Ww          , Ww          , Hh          , Hh          , Gs^Ft       , Gs          , Gs^Ft       , Gs^Vht      , Gs^Ft       , Gs^Ft       , Gs^Ft       , Gs^Ft       , Gs^Ft       , Gs^Ft       , Gs^Ft       , Gs^Ft       , Gs^Ft       , Gs^Ft       , Gs^Ft       , Gs^Ft       , Gs^Ft       , Gs^Edpp     , Gs^Ft       , Gs^Edpp     , Gs^Ft       , Gs^Edpp     , Gs^Edpp     , Gs^Edpp     , Gs^Edpp     , Gs^Edpp     , Gs^Edpp     , Gs^Edpp     , Gs^Edpp     , Gs^Edpp     , Gs^Edpp     
Re^Gvs      , Gs          , Gs          , Gs          , Gs          , Gs          , Gs          , Gs^Ft       , Gs^Ft       , Hh          , Hh          , Hh          , Ww          , Ww          , Wo          , Ww          , Ww          , Hh          , Hh          , Gs          , Gs          , Gs          , Gs          , Gs          , Gs          , Gs^Edpp     , Gs^Edpp     , Gs^Edpp     , Gs^Edpp     , Gs^Ft       , Ce          , Ce          , Ce          , Gs^Edpp     , Gs^Edpp     , Gs^Edpp     , Gs^Edpp     , Gs^Edpp     , Gs^Edpp     , Gs^Edpp     , Gs^Edpp     , Gs^Edpp     , Gs^Edpp     , Gs^Edpp     , Gs^Edpp     , Gs^Edpp     , Gs^Edpp     , Gs^Edpp     , Rr          , Rr          
Re^Gvs      , Re^Gvs      , Re^Gvs      , Gs          , Gs          , Gs          , Gs          , Gs^Ft       , Gs^Ft       , Gs^Ft       , Gs^Ft       , Hh          , Hh          , Ww          , Ww          , Ww          , Ww          , Wwf         , Wwf         , Wwf         , Wwf         , Gg          , Gg          , Gg          , Gg          , Gg          , Gg^Ft       , Gs^Edpp     , Gs^Edpp     , Gs^Edpp     , Ce          , 3 Ke        , Ce          , Gs^Edpp     , Gs^Edpp     , Gs^Edpp     , Gs^Edpp     , Gs^Vht      , Gs^Edpp     , Gs^Edpp     , Gs^Edpp     , Gs^Edpp     , Gs^Edpp     , Gs^Edpp     , Gs^Edpp     , Gs^Edpp     , Rr          , Rr          , Gs^Edpp     , Gs^Edpp     
Rr          , Re^Gvs      , Re          , Gs^Vht      , Re^Gvs      , Gs          , Gs          , Ss          , Gs^Ft       , Ss          , Gs          , Hh          , Hh          , Ww          , Ww          , Ww          , Wwf         , Wwf         , Wwf         , Wwf         , Wwf         , Wwf         , Wwf         , Wwf         , Wwf         , Wwf         , Wwf         , Gg^Ft       , Gg^Ft       , Gs^Edpp     , Gs^Edpp     , Ce          , Gs^Edpp     , Gs^Edpp     , Gs^Edpp     , Gs^Edpp     , Gs^Edpp     , Gs^Edpp     , Gs^Edpp     , Gs^Edpp     , Gs^Edpp     , Gs^Edpp     , Gs^Edpp     , Gs^Edpp     , Rr          , Rr          , Gs^Edpp     , Gs^Edpp     , Gs^Edpp     , Gs^Edpp     
Gs          , Rr          , Rr          , Re^Gvs      , Re^Gvs      , Re^Gvs      , Re^Gvs      , Gs^Ft       , Gs          , Gs          , Gs          , Gs          , Hh          , Ww          , Ww          , Hh^Vhh      , Hh          , Wwf         , Wwf         , Wwf         , Wwf         , Wwf         , Wwf         , Wwf         , Wwf         , Wwf         , Wwf         , Ww          , Ww          , Gg          , Gg          , Gs^Edpp     , Gs^Edpp     , Gs^Edpp     , Gs^Edpp     , Gs^Edpp     , Gs^Edpp     , Gs^Edpp     , Gs^Edpp     , Gs^Edpp     , Gs^Edpp     , Gs^Edpp     , Rr          , Rr          , Gs^Edpp     , Gs^Edpp     , Gs^Edpp     , Gs^Edpp     , Gs^Edpp     , Gs^Edpp     
Gs          , Gs          , Gs          , Rr          , Rr          , Re^Gvs      , Re^Gvs      , Re^Gvs      , Re          , Gs^Vht      , Gs          , Gs          , Gg          , Ww          , Ww          , Hh          , Mm          , Hh          , Hh          , Wwf         , Wwf         , Wwf         , Wwf         , Wwf         , Wwf         , Wwf         , Wwf         , Ww          , Wo          , Ww          , Ww          , Gg^Ft       , Gg^Ft       , Gs^Edpp     , Gs^Ft       , Gs^Edpp     , Gs^Edpp     , Gs^Edpp     , Gs^Edpp     , Gs^Edpp     , Rr          , Rr          , Gs^Edpp     , Gs^Edpp     , Gs^Edpp     , Gs^Vht      , Gs^Edpp     , Gs^Edpp     , Gs^Edpp     , Gs^Edpp     
Gs          , Gs          , Ce          , Gs          , Gs          , Rr          , Rr          , Re          , Re^Gvs      , Re^Gvs      , Re^Gvs      , Gs          , Gg          , Ww          , Ww          , Hh          , Hh          , Hh          , Hh          , Hh          , Gg          , Wwf         , Gg          , Wwf         , Gg          , Wwf         , Wwf         , Ww          , Ww          , Wo          , Wo          , Ww          , Ww          , Gg^Ft       , Gg^Ft       , Gs^Edpp     , Gs^Edpp     , Gs^Edpp     , Rr          , Rr          , Gs^Edpp     , Gs^Edpp     , Gs^Edpp     , Gs^Edpp     , Gs^Edpp     , Gs^Edpp     , Gs^Edpp     , Gs^Edpp     , Gs^Edpp     , Gs^Edpp     
Gs          , Ce          , 2 Ke        , Ce          , Gs          , Gs          , Gs          , Rr          , Rr          , Re^Gvs      , Gs          , Gs          , Gg          , Ww          , Ww          , Hh          , Gs^Ft       , Gs^Ft       , Re^Gvs      , Re^Gvs      , Re^Gvs      , Gg          , Gs          , Gg          , Hh          , Gg          , Gg          , Gg^Ft       , Gg^Ft       , Ww          , Ww          , Wo          , Wo          , Ww          , Ww          , Gg          , Rr          , Rr          , Gs^Edpp     , Gs^Edpp     , Gs^Edpp     , Gs^Edpp     , Gs^Edpp     , Gs^Edpp     , Gs^Edpp     , Gs^Edpp     , Ss          , Gs^Edpp     , Gs^Edpp     , Gs^Edpp     
Gs          , Ce          , Ce          , Ce          , Gs          , Gs          , Re^Gvs      , Gs          , Gs          , Rr          , Rr          , Gs          , Gg          , Ww          , Ww          , Hh          , Re^Gvs      , Re^Gvs      , Re^Gvs      , Re^Gvs      , Re^Gvs      , Re^Gvs      , Re^Gvs      , Gs          , Gs          , Gs          , Gs          , Gs^Ft       , Gs^Ft       , Gg^Ft       , Gg^Ft       , Ww          , Ww          , Wo          , Wo^Bsb/     , Ww^Bsb/     , Gg          , Gs^Edpp     , Gs^Edpp     , Gs^Edpp     , Gs^Edpp     , Gs^Edpp     , Gs^Edpp     , Gs^Edpp     , Gs^Edpp     , Gs^Edpp     , Gs^Edpp     , Gs^Edpp     , Gs^Edpp     , Gs^Edpp     
Gs          , Gs          , Gs          , Gs          , Re^Gvs      , Hh          , Re^Gvs      , Re^Gvs      , Re          , Re          , Gs          , Rr          , Chr         , Ww          , Ww          , Hh          , Re^Gvs      , Re^Gvs      , Re^Gvs      , Re^Gvs      , Gs^Vht      , Re^Gvs      , Re^Gvs      , Re^Gvs      , Re^Gvs      , Re^Gvs      , Re^Gvs      , Gs          , Gs          , Gs^Ft       , Ch          , Kh          , Rr          , Ww^Bsb/     , Wo          , Ww          , Gg          , Gs^Edpp     , Gs^Edpp     , Gs^Edpp     , Gs^Edpp     , Gs^Edpp     , Gs^Edpp     , Gs^Vht      , Gs^Edpp     , Gs^Edpp     , Gs^Edpp     , Gs^Edpp     , Gs^Edpp     , Gs^Edpp     
Re^Gvs      , Gs          , Gs          , Re^Gvs      , Re^Gvs      , Re^Gvs      , Gs^Vht      , Re          , Re^Gvs      , Re^Gvs      , Re^Gvs      , Gs          , Gg          , Ww^Bsb\     , Ww^Bsb\     , Gg          , Gs          , Re^Gvs      , Gs          , Gs          , Re^Gvs      , Re^Gvs      , Re^Gvs      , Re^Gvs      , Re^Gvs      , Re^Gvs      , Gs          , Gs          , Ch          , Ch          , Rr          , Rr          , Kh          , Ww          , Wo          , Ww          , Gg^Ft       , Gs^Edpp     , Gs^Edpp     , Gs^Edpp     , Gs^Edpp     , Gs^Edpp     , Gs^Edpp     , Gs^Edpp     , Gs^Edpp     , Gs^Edpp     , Gs^Edpp     , Gs^Edpp     , Gs^Edpp     , Gs^Edpp     
Re^Gvs      , Re^Gvs      , Gs          , Re^Gvs      , Re^Gvs      , Re^Gvs      , Re^Gvs      , Re^Gvs      , Re^Gvs      , Re^Gvs      , Gs          , Gs          , Gg          , Ww          , Ww          , Ch          , Rr          , Gs          , Gs          , Hh^Wm       , Re^Gvs      , Re^Gvs      , Re^Gvs      , Re^Gvs      , Gs          , Gs          , Ch          , Ch          , Rr          , Rr          , Rr          , Rr          , Ch          , Ww          , Wo          , Ww          , Gg^Ft       , Gs^Edpp     , Gs^Edpp     , Gs^Edpp     , Gs^Edpp     , Gs^Edpp     , Gs^Edpp     , Gs^Edp      , Gs^Edpp     , Gs^Edpp     , Gs^Edpp     , Gs^Edpp     , Gs^Edpp     , Gs^Edpp     
Hh          , Re^Gvs      , Gs          , Re^Gvs      , Re^Gvs      , Re^Gvs      , Re^Gvs      , Re^Gvs      , Ss          , Hh          , Hh          , Gs          , Gg          , Ww          , Ww          , Gg          , Gs          , Rr          , Rr          , Re^Gvs      , Re^Gvs      , Re^Gvs      , Gs          , Gs          , Ch          , Ch          , Rr          , Rr          , Rr          , Rr          , Rr          , Rr          , Ch          , Ww          , Wo          , Ww          , Gg^Ft       , Gs^Ft       , Gs^Ft       , Gs^Edpp     , Gs^Edpp     , Gs^Edpp     , Gs^Edpp     , Gs^Edpp     , Gs^Edpp     , Gs^Edpp     , Gs^Edpp     , Gs^Edpp     , Gs^Edpp     , Gs^Edpp     
Hh          , Hh          , Gs          , Re^Gvs      , Re^Gvs      , Re^Gvs      , Re^Gvs      , Gs          , Gs^Ft       , Gs^Ft       , Gs^Ft       , Gs^Ft       , Gg          , Ww          , Ww          , Gg          , Gs          , Re^Gvs      , Re^Gvs      , Rr          , Rr          , Gs          , Kh          , Ch          , Ch          , Rr^Vhc      , Rr          , Rr          , Rr          , Rr          , Rr          , Rr          , Ch          , Ww          , Wo          , Ww          , Ss^Vhs      , Gs^Ft       , Gs^Ft       , Gs^Edpp     , Gs^Edpp     , Gs^Edpp     , Gs^Edpp     , Gs^Vht      , Gs^Edpp     , Gs^Edpp     , Gs^Edpp     , Gs^Edpp     , Gs^Edpp     , Gs^Edpp     
Hh          , Hh          , Gs          , Re^Gvs      , Re^Gvs      , Re^Gvs      , Re^Gvs      , Gs          , Hh          , Gs^Ft       , Gs^Ft       , Gs^Ft       , Gg          , Ww          , Ww          , Gg          , Gs          , Re^Gvs      , Gs          , Gs          , Kh          , Rr          , Rr          , Rr^Vhc      , Rr          , Kh          , Rr          , Rr          , Rr          , Rr          , Rr          , Rr^Vhc      , Ch          , Ww          , Wo          , Ww          , Gg^Ft       , Gs^Ft       , Gs^Edpp     , Gs^Edpp     , Gs^Edpp     , Gs^Edpp     , Gs^Edpp     , Gs^Edpp     , Gs^Edpp     , Gs^Edpp     , Gs^Edp      , Gs^Edp      , Gs^Edp      , Gs^Edpp     
Hh          , Hh          , Gs          , Re^Gvs      , Re^Gvs      , Re^Gvs      , Gs          , Gs          , Gs          , Hh          , Gg          , Gg          , Ww          , Ww          , Ww          , Gg          , Gs          , Gs          , Ch          , Ch          , Rr          , Rr          , Rr          , Rr          , Rr          , Rr          , Rr          , Kh          , Ch          , Rr          , Ch          , Ch          , Ww          , Ww          , Wo          , Ww          , Gg^Ft       , Gs^Ft       , Gs^Edpp     , Gs^Edpp     , Gs^Edpp     , Gs^Edpp     , Gs^Edpp     , Gs^Edpp     , Gs^Edpp     , Gs^Edpp     , Gs^Edp      , Gs^Edp      , Gs^Edpp     , Gs^Edpp     
Rr          , Hh          , Gs          , Re          , Gs^Vht      , Gs          , Gs          , Gs          , Gg          , Gg          , Ww          , Ww          , Wo          , Wo          , Ww          , Gg          , Kh          , Ch          , Rr          , Rr          , Rr          , Rr          , Rr          , Rr          , Rr          , Rr          , Rr          , Rr          , Rr          , Kh          , Ww          , Ww          , Wo          , Wo          , Ww          , Ww          , Gg          , Gs^Edpp     , Gs^Edpp     , Gs^Edpp     , Gs^Edpp     , Gs^Edpp     , Gs^Edpp     , Gs^Edpp     , Gs^Edp      , Gs^Edp      , Gs^Edp      , Gs^Edpp     , Gs^Edpp     , Gs^Edpp     
Hh          , Rr          , Rr          , Re          , Gs          , Gs          , Gg          , Gg          , Ww          , Ww          , Wo          , Wo          , Wo          , Wo          , Kh          , Ww          , Ww          , Rr          , Rr          , Rr          , Cv          , Cv          , Cv          , Rr          , Rr          , Rr          , Rr          , Rr          , Kh          , Ww^Bsb\     , Wo^Bsb\     , Wo          , Ww          , Ww          , Gg          , Gg          , Gs^Edpp     , Gs^Edpp     , Gs^Edpp     , Gs^Edpp     , Gs^Edpp     , Gs^Edpp     , Gs^Edpp     , Gs^Edpp     , Gs^Edpp     , Gs^Edp      , Gs^Edp      , Gs^Edpp     , Gs^Edpp     , Gs^Edpp     
Hh          , Gs          , Rr          , Rr          , Rr          , Gs          , Gg          , Ww          , Wo          , Wo          , Wo          , Wo          , Ww^Bw\      , Ww          , Rr          , Ch          , Rr          , Ww^Bsb/     , Ww          , Rr^Vhc      , Cv          , Gg^Ve       , Cv          , Rr          , Rr          , Rr          , Rr          , Rr          , Ch          , Ww          , Wo          , Ww^Bsb\     , Rr          , Gg          , Gs^Edpp     , Gs^Edpp     , Gs^Edpp     , Gs^Edpp     , Gs^Edpp     , Gs^Edpp     , Gs^Edpp     , Gs^Edpp     , Ce          , Ce          , Ce          , Gs^Edpp     , Gs^Edpp     , Gs^Edp      , Gs^Edpp     , Gs^Edpp     
Gs          , Gs          , Rr          , Gs          , Gg          , Rr          , Ww^Bsb\     , Ww          , Ww          , Wo          , Ww^Bw\      , Ww^Bw\      , Rr          , Rr          , Cud         , Rr          , Rr          , Ch          , Ch          , Ww          , Ww          , Cv          , Rr^Vhc      , Rr          , Rr          , Rr          , Rr          , Rr^Vhc      , Ch          , Ww          , Wo          , Ww          , Gg          , Rr          , Rr          , Gs^Edpp     , Gs^Edpp     , Gs^Edpp     , Gs^Vht      , Gs^Edpp     , Gs^Edpp     , Gs^Edpp     , Ce          , 4 Ke        , Ce          , Gs^Edpp     , Gs^Edpp     , Gs^Edpp     , Gs^Edpp     , Gs^Edpp     
Gs          , Gs          , Rr          , Gg          , Ww          , Ww          , Ww          , Ww^Bsb\     , Ww^Bsb\     , Ww          , Rr          , Rr          , Cud         , Cud         , 1 Kud       , Cud         , Rr          , Rr          , Rr          , Ch          , Ch          , Ww          , Ww^Bsb/     , Rr          , Rr          , Rr          , Ch          , Ch          , Ww          , Ww          , Wo          , Ww          , Gs^Ft       , Gs          , Gs^Edpp     , Rr          , Rr          , Gs^Edpp     , Gs^Edpp     , Gs^Edpp     , Gs^Edpp     , Gs^Edpp     , Gs^Edpp     , Ce          , Gs^Edpp     , Gs^Edpp     , Gs^Edpp     , Gs^Edpp     , Gs^Edpp     , Gs^Edpp     
Gg          , Gg          , Ww^Bsb|     , Ww          , Ww          , Ww          , Ch          , Kh          , Rr^Vhc      , Rr          , Rr          , Rr          , Cud         , 5 Kud       , Cud         , Cud         , Rr          , Rr          , Rr          , Rr          , Rr          , Rr          , Ch          , Ww          , Ww          , Kh          , Ww          , Ww          , Wo          , Wo          , Ww          , Ww          , Gs^Ft       , Gs          , Gs^Edpp     , Gs^Edpp     , Gs^Edp      , Rr          , Rr          , Gs^Edpp     , Gs^Edpp     , Gs^Edpp     , Gs^Edpp     , Gs^Edpp     , Gs^Edpp     , Gs^Edpp     , Gs^Edpp     , Gs^Edpp     , Gs^Ft       , Gs^Ft       
Ww          , Ww          , Ww^Bsb|     , Ww          , Ch          , Ch          , Rr^Vhc      , Chr         , Chr         , Rr          , Rr          , Rr          , Rr          , Cud         , Rr          , Rr          , Rr          , Rr          , Rr          , Rr          , Rr          , Rr          , Ch          , Kh          , Ww          , Ww          , Wo          , Wo          , Ww          , Ww          , Gs^Ft       , Gs^Ft       , Gs^Ft       , Gs^Ft       , Gs^Ft       , Gs^Edpp     , Gs^Ft       , Gs^Edp      , Gs^Edp      , Rr          , Rr          , Gs^Edpp     , Gs^Edpp     , Gs^Edpp     , Gs^Edpp     , Gs^Edpp     , Gs^Edpp     , Gs^Ft       , Gs^Ft       , Gs^Ft       
Ww          , Ww          , Rr          , Kh          , Rr          , Rr          , Rr          , Rr          , Rr          , Kh          , Rr          , Rr          , Rr          , Rr          , Rr          , Rr          , Rr          , Ww^Ewl      , Rr          , Rr          , Rr          , Rr          , Ww          , Ww          , Wo          , Wo          , Ww          , Ww          , Gs^Ft       , Gs^Ft       , Gs^Ft       , Gs^Ft       , Gs^Ft       , Gs^Ft       , Gs^Ft       , Gs^Ft       , Gs^Ft       , Gs^Edp      , Gs^Edpp     , Gs^Edpp     , Gs^Edpp     , Rr          , Rr          , Gs^Edpp     , Gs^Edpp     , Gs^Edpp     , Gs^Edpp     , Gs^Ft       , Gs^Ft       , Gs^Ft       
Ch          , Kh          , Rr          , Rr          , Rr          , Rr          , Rr          , Rr          , Rr          , Rr          , Rr          , Kh          , Chr         , Rr          , Rr^Vhc      , Rr          , Rr          , Rr          , Rr          , Rr          , Ww^Bw\      , Ww^Bw\      , Wo          , Wo          , Wo          , Wo          , Ww          , Ww          , Gs^Ft       , Gs^Ft       , Gs^Edpp     , Gs^Edpp     , Gs^Edpp     , Gs^Ft       , Gs^Edpp     , Gs^Ft       , Gs^Vht      , Gs^Edp      , Gs^Edpp     , Gs^Edpp     , Gs^Edpp     , Gs^Edpp     , Gs^Edpp     , Rr          , Rr          , Gs^Edpp     , Gs^Edpp     , Gs^Edpp     , Gs^Ft       , Gs^Ft       
Ch          , Rr^Vhc      , Rr          , Rr          , Rr          , Rr          , Rr          , Rr          , Rr          , Rr          , Rr          , Rr          , Rr          , Chr         , Chr         , Ch          , Ch          , Rr          , Ww^Bw\      , Ww^Bw\      , Wo          , Wo          , Wo          , Wo          , Wo          , Wo          , Ww          , Ww          , Ss^Vhs      , Gs          , Gs^Edpp     , Gs          , Gs^Edpp     , Gs^Edpp     , Gs^Edpp     , Gs^Edpp     , Gs^Edpp     , Gs^Edpp     , Gs^Edpp     , Ss          , Gs^Edpp     , Gs^Edpp     , Gs^Edpp     , Gs^Edpp     , Gs^Edpp     , Rr          , Rr          , Gs^Edpp     , Gs^Edpp     , Gs^Ft       
Ch          , Rr          , Rr          , Rr          , Rr          , Rr          , Rr          , Rr          , Rr          , Rr          , Rr          , Rr          , Rr          , Rr^Vhc      , Ch          , Kh          , Ww          , Ww          , Wo          , Wo          , Wo          , Wo          , Wo          , Wo          , Wo          , Wo          , Ww          , Ww          , Gs^Ft       , Gs^Ft       , Gs^Ft       , Gs^Edpp     , Gs^Edpp     , Gs^Edpp     , Gs^Edpp     , Gs^Edpp     , Gs^Edpp     , Gs^Edpp     , Gs^Edpp     , Gs^Edpp     , Gs^Edpp     , Gs^Edpp     , Gs^Edpp     , Gs^Edpp     , Gs^Edpp     , Gs^Edpp     , Gs^Edpp     , Rr          , Rr          , Gs^Edpp     
Kh          , Rr          , Rr          , Rr          , Rr          , Rr          , Rr          , Rr          , Rr          , Rr          , Rr          , Rr          , Rr          , Rr          , Ww          , Ww          , Wo          , Wo          , Wo          , Wo          , Wo          , Wo          , Wo          , Wo          , Wo          , Wo          , Ww          , Ww          , Gs^Ft       , Gs^Ft       , Gs          , Gs^Edpp     , Gs^Edpp     , Gs^Edpp     , Gs^Ft       , Gs^Ft       , Gs^Ft       , Gs^Ft       , Gs^Ft       , Gs^Edpp     , Gs^Edpp     , Gs^Edpp     , Gs^Edpp     , Gs^Edpp     , Gs^Edpp     , Gs^Edpp     , Gs^Edpp     , Gs^Edpp     , Gs^Edpp     , Rr          
Rr          , Rr          , Rr          , Rr          , Rr^Vhc      , Rr          , Rr^Vhc      , Rr          , Rr          , Rr          , Rr          , Rr          , Ww^Bw\      , Ww^Bw\      , Wo          , Wo          , Wo          , Wo          , Wo          , Wo          , Wo          , Wo          , Wo          , Wo          , Wo          , Wo          , Ww          , Ww          , Ww          , Ss^Vhs      , Gs^Ft       , Gs^Edpp     , Gs^Ft       , Gs^Ft       , Gs^Ft       , Gs^Ft       , Gs^Ft       , Gs^Ft       , Gs^Ft       , Gs^Ft       , Gs^Ft       , Gs^Ft       , Gs^Ft       , Gs^Ft       , Gs^Ft       , Gs^Edpp     , Gs^Ft       , Gs^Ft       , Gs^Ft       , Gs^Edpp     
Rr          , Kh          , Ch          , Ch          , Ch          , Ch          , Ch          , Ch          , Ch          , Rr          , Ww          , Ww^Bw\      , Wo          , Wo          , Wo          , Wo          , Wo          , Wo          , Wo          , Wo          , Wo          , Wo          , Wo          , Wo          , Wo          , Wo          , Wo          , Ww          , Ww          , Gs^Ft       , Gs^Ft       , Gs^Ft       , Gs^Ft       , Gs^Ft       , Gs^Ft       , Gs^Ft       , Gs^Ft       , Gs^Ft       , Gs^Ft       , Gs^Ft       , Gs^Ft       , Gs^Ft       , Gs^Ft       , Gs^Ft       , Gs^Ft       , Gs^Ft       , Gs^Ft       , Gs^Ft       , Gs^Ft       , Gs          
