border_size=1
usage=map

Gd^Fdw      , Gd^Fdw      , Gd          , Gd          , Gd          , Gd          , Gd          , Gd          , Gd          , Gd          , Gd          , Gd          , Gd          , Gd          , Re^Fdw      , Re^Fdw      , Re^Fdw      , Re^Fdw      , Re^Fdw      , Re^Fdw      , Re^Fdw      , Re^Fdw      , Re^Fdw      , Gd          , Gd          , Gd          , Gd          , Gd          , Gd          , Hhd         , Hhd         , Hhd         , Hhd         , Hhd         , Hhd         , Hhd         , Hhd         , Hhd         , Hhd         , Hhd         , Hhd         , Hhd         , Hhd         , Hhd         , Hhd         , Hhd         , Hhd         , Hhd         , Hhd         , Hhd         
Gd^Fdw      , Gd^Fdw      , Gd          , Gd          , Gd          , Gd          , Gd          , Gd          , Gd          , Gd          , Rb          , Gd          , Gd          , Gd          , Gd          , Gd^Fdw      , Gd^Fdw      , Gd^Fdw      , Gd          , Gd^Fdw      , Gd          , Gd          , Gd          , Gd          , Gd          , Gd          , Gd          , Gd          , Gd          , Gd          , Gd          , Hhd         , Hhd         , Hhd         , Hhd         , Hhd         , Hhd         , Hhd         , Hhd         , Hhd         , Hhd         , Hhd         , Hhd         , Hhd         , Hhd^Vhh     , Hhd         , Hhd         , Hhd         , Hhd         , Hhd         
Gd^Fdw      , Gd^Fdw      , Gd          , Gd          , Gd          , Gd          , Gd          , Gd          , Gd          , Gd          , Rb          , Gd          , Gd          , Gd          , Gd          , Gd          , Gd          , Gd          , Gd          , Gd          , Gd          , Gd          , Gd          , Gd          , Gd          , Gd          , Hhd         , Re          , Re          , Gd          , Re          , Gd          , Chr         , Hhd         , Hhd         , Hhd         , Hhd         , Hhd         , Hhd         , Hhd         , Hhd^Vhh     , Hhd         , Gd          , Gd          , Gd          , Gd          , Gd          , Hhd         , Hhd         , Hhd         
Gd^Fdw      , Gd          , Gd          , Gd          , Gd          , Gd          , Gd          , Gd          , Gd          , Gd          , Rb          , Re^Vct      , Gd          , Gd          , Re          , Gd          , Gd          , Gd          , Re          , Gd^Vh       , Gd          , Gd          , Gd          , Gd          , Gd          , Hhd         , Hhd         , Hhd         , Re          , Re          , Chr         , Re          , Gd          , Gd          , Gd          , Hhd         , Re          , Hhd         , Gd          , Hhd         , Gd          , Gd          , Rb^Dr       , Rb          , Rb          , Gd          , Gd          , Gd          , Gd          , Hhd         
Gd^Fdw      , Gd^Fdw      , Gd          , Gd          , Gd          , Gd          , Gd          , Gd          , Gd          , Re^Vct      , Co          , Co          , Co          , Re^Vct      , Gd          , Gd          , Gd          , Gd          , Gd          , Gd          , Gd          , Gd          , Gd          , Gd          , Re          , Hhd         , Hhd         , Hhd         , Hhd         , Hhd         , Hhd         , Gd          , Rp          , Gd^Edpp     , Gd          , Gd          , Gd          , Gd          , Gd          , Gd          , Gd          , Gd          , Chr         , Khr         , Chr         , Rp          , Rp          , Gd          , Gd          , Gd          
Gd^Fdw      , Gd^Fdw      , Gd          , Gd          , Gd^Vh       , Gd          , Gd          , Gd          , Gd          , Gd          , Co          , 2 Ko        , Co          , Gd          , Gd          , Gd          , Gd          , Gd          , Gd          , Gd          , Gd          , Gd          , Gd          , Gd          , Re          , Hhd         , Hhd         , Hhd         , Re          , Hhd         , Chr         , Gd          , Gd          , Rp          , Gd          , Rp          , Gd          , Rp          , Rp          , Gd          , Rp          , Rp          , Gd          , Rb^Dr       , Gd          , Gd          , Gd          , Rp          , Rp          , Gd          
Hhd         , Hhd         , Gd          , Gd          , Gd          , Gd          , Re          , Gd          , Gd          , Re^Vct      , Rb          , Co          , Gd          , Re^Vct      , Gd          , Gd          , Gd          , Gd          , Gd          , Gd          , Gd          , Gd          , Gd          , Re          , Hhd         , Hhd         , Hhd         , Re          , Re          , Hhd         , Re          , Re          , Chr         , Gd          , Hhd         , Gd          , Gd          , Re          , Gd          , Rp          , Gd          , Gd          , Gd^Vh       , Gd          , Gd          , Gd          , Re          , Gd          , Gd          , Rp          
Hhd         , Hhd         , Hhd         , Gd          , Gd          , Gd          , Gd          , Gd          , Gd          , Gd          , Rb          , Re^Vct      , Gd          , Gd          , Gd          , Re          , Gd          , Gd^Edpp     , Gd          , Re          , Gd          , Gd          , Gd          , Re          , Hhd         , Hhd         , Re          , Hhd         , Re          , Re          , Gd          , Gd          , Gd          , Hhd         , Hhd         , Hhd         , Hhd         , Gd          , Gd          , Gd          , Gd          , Gd^Edpp     , Gd          , Re          , Gd          , Gd          , Gd          , Gd          , Gd          , Gd          
Hhd         , Hhd         , Hhd         , Gd          , Gd          , Gd          , Gd          , Gd          , Gd          , Gd          , Rb          , Gd          , Gd          , Gd          , Re          , Gd          , Gd          , Gd          , Gd          , Gd          , Gd          , Gd          , Gd          , Re          , Hhd         , Hhd         , Re          , Re          , Gd          , Gd          , Gd          , Gd          , Gd          , Hhd         , Hhd         , Hhd         , Hhd         , Hhd         , Hhd         , Gd          , Re          , Gd          , Gd          , Gd          , Hhd         , Gd^Vhh      , Hhd         , Hhd         , Hhd         , Gd          
Hhd         , Hhd         , Gd          , Gd          , Gd          , Gd          , Re          , Gd          , Rb          , Rb          , Gd          , Gd          , Gd          , Gd          , Gd          , Gd          , Gd          , Gd          , Gd          , Gd^Fdw      , Gd          , Gd          , Gd          , Hhd         , Re          , Gd^Vh       , Gd          , Gd          , Gd          , Gd          , Gd          , Gd          , Dd          , Dd          , Gd          , Hhd         , Hhd         , Hhd         , Hhd         , Hhd         , Hhd         , Hhd         , Hhd         , Hhd         , Hhd         , Hhd         , Hhd         , Hhd         , Hhd         , Hhd         
Gd          , Hhd         , Gd          , Gd          , Gd          , Gd          , Gd          , Gd          , Rb          , Gd          , Gd          , Gd          , Gd          , Gd          , Gd          , Re          , Gd          , Gd          , Gd          , Gd          , Gd          , Gd          , Gd          , Re          , Gd          , Re          , Gd          , Gd          , Gd          , Dd          , Dd          , Dd          , Dd          , Gd          , Gd          , Gd          , Gd          , Hhd         , Hhd         , Hhd         , Hhd         , Hhd         , Hhd         , Hhd         , Hhd         , Hhd         , Hhd         , Hhd         , Hhd         , Hhd         
Gd          , Gd          , Gd          , Gd          , Gd          , Gd          , Gd          , Gd          , Rb          , Gd          , Gd          , Gd          , Gd          , Gd          , Gd^Fdw      , Gd^Vh       , Gd          , Gd          , Gd          , Re          , Gd          , Gd          , Gd          , Gd          , Gd          , Gd          , Gd          , Gd          , Dd          , Dd          , Dd          , Dd          , Dd          , Dd          , Re          , Gd          , Gd          , Gd          , Gd          , Hhd         , Hhd         , Hhd         , Hhd         , Hhd         , Hhd         , Hhd         , Hhd         , Hhd         , Hhd         , Hhd         
Gd          , Gd          , Gd          , Gd          , Gd          , Gd          , Gd          , Gd^Vct      , Rb          , Gd          , Gd          , Gd          , Gd          , Gd          , Gd          , Gd          , Re          , Gd          , Gd          , Gd          , Gd          , Gd          , Gd^Dr       , Gd          , Dd          , Dd          , Dd          , Dd          , Dd          , Dd          , Dd          , Dd          , Dd          , Dd          , Dd          , Gd          , Dd          , Re          , Gd          , Re          , Gd          , Re          , Re          , Re          , Gd          , Hhd         , Hhd         , Hhd         , Hhd         , Hhd         
Gd          , Gd          , Gd          , Gd          , Gd          , Gd          , Rrc         , Rrc         , Gd          , Gd          , Dd          , Gd          , Gd          , Re          , Dd          , Dd          , Gd          , Gd          , Gd          , Gd          , Dd          , Gd          , Dd          , Dd          , Dd          , Dd          , Dd          , Dd          , Gd          , Dd          , Gd          , Dd          , Gd          , Dd          , Dd          , Dd          , Dd          , Dd          , Dd          , Gd          , Gd          , Gd          , Gd          , Gd          , Gd          , Gd          , Gd          , Re          , Gd          , Gd          
Gd          , Gd          , Gd          , Gd          , Rrc         , Rrc         , Gd          , Gd          , Re          , Dd          , Dd          , Dd          , Dd          , Dd          , Dd          , Dd          , Gd          , Re          , Gd          , Gd          , Dd          , Dd          , Dd          , Dd          , Gd          , Dd          , Gd          , Dd          , Re          , Gd          , Gd          , Gd          , Re          , Gd          , Dd          , Dd          , Gd          , Dd          , Dd          , Re          , Dd          , Gd          , Gd          , Gd          , Gd^Vh       , Gd          , Gd          , Gd          , Gd          , Gd          
Gd          , Gd          , Rrc         , Rrc         , Gd          , Gd          , Gd          , Gd          , Gd          , Dd          , Dd          , Dd          , Dd          , Dd          , Re          , Gd          , Gd          , Gd          , Gd^Fdw      , Gd          , Gd          , Dd          , Gd          , Dd          , Re          , Gd          , Gd          , Gd          , Gd          , Gd          , Gd          , Gd^Vh       , Gd          , Dd          , Dd          , Gd          , Re          , Gd          , Gd          , Dd          , Gd          , Re          , Gd          , Gd          , Gd          , Re          , Gd          , Gd          , Gd          , Gd          
Rrc         , Rrc         , Gd          , Gd          , Gd          , Gd          , Gd^Edpp     , Gd          , Gd          , Dd          , Re          , Dd          , Gd          , Gd          , Gd          , Gd          , Re          , Gd          , Gd          , Gd          , Dd          , Dd          , Gd          , Gd          , Gd          , Gd          , Re          , Gd          , Gd          , Gd          , Gd          , Re          , Dd          , Dd          , Gd          , Gd          , Gd^Fdw      , Gd          , Gd          , Re          , Gd          , Gd          , Re          , Gd          , Gd          , Gd          , Re          , Gd          , Gd          , Gd          
Gd          , Gd          , Re          , Gd          , Gd          , Gd          , Gd          , Gd          , Dd          , Dd          , Dd          , Gd          , Gd          , Gd^Fdw      , Gd          , Gd          , Dd          , Dd          , Dd          , Dd          , Gd          , Gd          , Gd          , Gd          , Gd          , Hhd         , Hhd         , Re          , Gd          , Gd          , Gd          , Gd          , Gd          , Dd          , Gd          , Gd          , Re          , Gd          , Gd          , Gd          , Gd          , Gd          , Gd          , Gd          , Gd^Edpp     , Gd          , Gd          , Gd          , Gd          , Gd          
Gd          , Gd          , Gd          , Gd          , Dd          , Dd          , Dd          , Dd          , Gd          , Dd          , Gd          , Gd          , Gd          , Gd          , Re          , Gd          , Gd          , Dd          , Dd          , Dd          , Gd          , Gd          , Gd          , Gd          , Gd          , Hhd         , Hhd         , Hhd         , Gd          , Gd          , Gd          , Gd          , Gd          , Gd          , Re          , Gd          , Gd          , Gd          , Re          , Gd          , Gd          , Re          , Gd          , Gd          , Gd          , Gd          , Gd^Fdw      , Gd          , Gd          , Gd          
Gd          , Gd          , Gd          , Gd          , Gd          , Gd          , Gd          , Gd          , Re          , Gd          , Gd          , Gd          , Gd          , Gd          , Gd          , Gd          , Gd          , Re          , Re          , Gd          , Gd          , Re          , Gd          , Gd          , Gd          , Gd          , Gd          , Gd          , Gd          , Gd          , Re          , Re          , Re          , Re          , Gd          , Re          , Gd          , Gd          , Gd          , Gd          , Re          , Gd          , Gd          , Re          , Gd          , Gd          , Gd          , Gd          , Gd          , Gd          
Gd          , Gd          , Gd          , Gd          , Gd          , Gd          , Hhd         , Gd          , Gd          , Gd          , Hhd         , Hhd         , Hhd         , Gd          , Gd          , Gd^Vh       , Gd          , Gd          , Gd          , Gd          , Gd          , Gd          , Gd          , Gd          , Gd          , Gd^Vhr      , Gd          , Gd          , Gd          , Gd          , Gd          , Gd          , Gd          , Gd          , Gd          , Gd          , Gd          , Re          , Gd          , Re          , Re          , Re          , Gd          , Gd          , Gd          , Gd          , Gd          , Gd          , Gd          , Gd          
Gd          , Gd          , Hhd         , Re          , Hhd         , Hhd         , Hhd         , Hhd         , Hhd         , Hhd         , Hhd         , Hhd         , Hhd         , Hhd         , Gd          , Gd          , Gd          , Gd          , Gd          , Gd          , Gd          , Gd          , Dd          , Gd          , Gd          , Gd          , Gd          , Gd          , Rp          , Gd          , Gd          , Gd          , Gd          , Re          , Re          , Gd^Vh       , Gd          , Gd          , Gd          , Gd          , Gd          , Gd          , Gd          , Gd          , Gd          , Gd          , Gd          , Gd          , Gd^Vhr      , Gd          
Hhd         , Hhd         , Hhd         , Hhd         , Hhd         , Hhd         , Hhd         , Hhd         , Hhd         , Hhd         , Hhd         , Hhd         , Hhd         , Hhd         , Gd          , Gd          , Re          , Gd          , Gd          , Gd          , Dd          , Dd          , Dd          , Gd          , Gd          , Gd          , Gd          , Gd          , Gd          , Rp          , Gd          , Gd          , Gd          , Gd          , Gd          , Re          , Gd          , Gd          , Gd          , Gd          , Gd          , Re          , Gd          , Gd          , Gd          , Gd          , Gd          , Gd          , Gd          , Gd          
Hhd         , Hhd         , Hhd         , Hhd         , Hhd         , Hhd         , Hhd^Vh      , Hhd         , Hhd         , Hhd         , Hhd         , Hhd         , Gd          , Gd          , Gd          , Gd          , Gd          , Gd          , Dd          , Dd          , Dd          , Dd          , Re          , Gd          , Gd          , Gd          , Gd          , Gd          , Gd          , Rp          , Gd          , Gd          , Gd          , Gd          , Gd          , Gd          , Gd          , Gd          , Gd          , Gd          , Gd          , Re          , Gd          , Gd          , Gd          , Gd          , Gd          , Gd          , Gd          , Gd          
Hhd         , Hhd         , Hhd         , Hhd         , Hhd         , Hhd         , Hhd         , Hhd         , Hhd         , Hhd         , Re          , Re          , Gd          , Gd          , Gd^Edpp     , Gd          , Re          , Re          , Dd          , Dd          , Dd^Vda      , Dd          , Re          , Gd          , Re          , Gd          , Gd          , Gd          , Gd          , Gd          , Gd          , Gd          , Gd          , Gd          , Gd          , Gd          , Gd^Fdw      , Gd          , Gd          , Gd          , Gd          , Gd          , Gd          , Gd          , Gd          , Gd          , Gd          , Gd          , Gd          , Gd          
Hhd         , Hhd         , Hhd         , Hhd         , Hhd         , Hhd         , Hhd         , Hhd         , Hhd         , Hhd         , Gd          , Gd          , Gd          , Gd          , Gd          , Gd          , Dd          , Dd          , Dd          , Dd          , Dd          , Dd          , Gd          , Gd          , Gd          , Gd          , Gd          , Gd          , Gd          , Rp          , Gd          , Gd          , Gd          , Gd          , Gd          , Gd          , Gd          , Gd          , Gd          , Gd          , Gd          , Gd          , Gd          , Gd          , Gd          , Gd          , Gd          , Gd          , Gd          , Gd          
Hhd         , Hhd         , Hhd         , Hhd         , Hhd         , Hhd         , Hhd         , Hhd         , Gd          , Gd          , Gd          , Gd          , Re          , Re          , Gd          , Gd          , Re          , Dd          , Dd          , Dd          , Dd          , Dd          , Re          , Gd          , Re          , Gd          , Gd          , Gd          , Gd          , Gd          , Gd          , Gd          , Ce          , Gd          , Gd          , Gd          , Gd          , Gd          , Gd^Vh       , Gd          , Gd          , Gd^Edpp     , Gd          , Gd          , Hhd         , Hhd         , Re          , Gd          , Gd          , Gd          
Hhd         , Hhd         , Hhd         , Hhd         , Hhd         , Hhd         , Gd          , Gd          , Re          , Gd          , Gd          , Gd          , Gd          , Gd          , Gd          , Gd          , Gd          , Dd          , Dd          , Dd          , Dd          , Gd          , Gd          , Gd          , Gd          , Gd          , Gd          , Gd          , Gd          , Gd          , Gd          , Ce          , 1 Ke        , Ce          , Gd          , Gd          , Gd          , Gd          , Gd          , Gd          , Gd          , Gd          , Gd          , Gd          , Hhd         , Hhd         , Hhd         , Gd          , Gd          , Gd          
Hhd         , Hhd         , Hhd         , Hhd         , Hhd         , Gd          , Gd          , Gd^Vh       , Gd          , Gd          , Gd          , Gd          , Re          , Re          , Gd          , Gd          , Dd          , Dd          , Dd          , Dd          , Dd          , Re          , Gd          , Gd          , Gd          , Gd          , Gd^Vh       , Gd          , Gd          , Rp          , Gd          , Ce          , Ce          , Ce          , Gd          , Gd          , Gd          , Gd          , Gd          , Gd          , Gd          , Gd          , Gd          , Gd          , Hhd         , Hhd         , Hhd         , Re          , Hhd         , Re          
Hhd         , Hhd         , Hhd         , Hhd         , Hhd         , Gd          , Gd          , Gd          , Gd          , Re          , Gd          , Gd          , Gd          , Re          , Re          , Gd          , Dd          , Dd          , Dd          , Dd          , Dd          , Dd          , Gd          , Gd          , Gd          , Gd          , Gd          , Gd          , Gd          , Rp          , Rp          , Gd          , Gd          , Gd          , Gd          , Gd          , Gd          , Gd          , Gd          , Gd          , Gd          , Gd          , Gd          , Gd          , Re          , Hhd         , Hhd         , Hhd         , Hhd         , Hhd         
Hhd         , Hhd         , Hhd         , Hhd         , Hhd         , Hhd         , Hhd         , Gd          , Gd          , Gd          , Gd          , Re          , Gd          , Gd          , Dd          , Dd          , Dd          , Dd          , Dd          , Dd          , Dd          , Dd          , Dd          , Gd          , Gd          , Gd          , Gd          , Gd          , Gd          , Gd          , Gd          , Rp          , Gd          , Gd          , Gd          , Gd          , Gd          , Gd          , Gd          , Gd          , Gd          , Gd          , Gd          , Gd          , Re          , Hhd         , Hhd         , Hhd         , Hhd         , Hhd         
Hhd         , Hhd         , Hhd         , Hhd         , Hhd         , Hhd         , Hhd         , Gd          , Gd          , Gd          , Gd          , Gd          , Gd          , Dd          , Dd          , Dd          , Dd          , Dd          , Dd          , Dd          , Dd          , Dd          , Dd          , Gd          , Gd          , Gd          , Gd          , Gd          , Gd          , Gd          , Gd          , Rp          , Gd          , Gd          , Gd          , Gd          , Gd          , Gd          , Gd          , Gd          , Gd          , Gd          , Gd          , Hhd         , Hhd         , Hhd         , Hhd         , Hhd         , Hhd         , Hhd         
