border_size=1
usage=map

Gs^Ft       , Gs^Ft       , Gs^Ft       , Gs^Ft       , Gs^Ft       , Wog         , Wog         , Wog         , Wog         , Wwg         , Gs^Ft       , Hh          , Hh          , Gs^Ft       , Hh          , Gs^Ft       , Ss          , Ss          , Ss          , Ss          , Ss          , Ss          , Gs^Ft       , Gs^Ft       , Gs^Ft       , Gs^Ft       , Gs^Ft       , Gs^Ft       , Rb          , Rb          , Gs^Ft       , Gs^Ft       , Gs^Ft       , Gs^Ft       , Gs^Ft       , Gs^Ft       , Gs^Ft       , Hh          , Hh          , Hh          , Mm          , Mm          , Mm          , Mm          , Hh          , Mm          , Mm          , Mm          , Mm          , Mm          
Gs^Ft       , Gs^Ft       , Gs^Ft       , Gs^Ft       , Gs^Ft       , Wog         , Wog         , Wog         , Wog         , Wwg         , Wwrg        , Hh          , Gs^Ft       , Ss^Vhs      , Ss          , Gs^Ft       , Ss          , Ss          , Gs^Ft       , Gs^Ft       , Ss          , Ss          , Gs^Ft       , Gs^Ft       , Gs^Ft       , Gs^Ft       , Gs^Ft       , Gs^Ft       , Rb          , Gs^Ft       , Gs^Ft       , Gs^Ft       , Gs^Ft       , Gs^Ft       , Gs^Ft       , Hh          , Hh          , Hh          , Hh          , Mm          , Mm          , Mm          , Mm          , Mm          , Mm          , Mm          , Mm          , Mm          , Mm          , Mm          
Ss          , Gs^Vo       , Gs^Ft       , Gs^Ft       , Gs^Ft       , Wog         , Wog         , Wog         , Wog         , Wwg         , Wwrg        , Wwrg        , Wwrg        , Gs^Ft       , Ss          , Ss          , Ss          , Gs^Ft       , Rb^Em       , Ss          , Ss          , Gs^Ft       , Ss          , Gs^Ft       , Gs^Ft       , Co          , Rb          , Rb          , Gs^Ft       , Gs^Ft       , Gs^Ft       , Gs^Ft       , Gs^Ft       , Hh          , Hh          , Hh          , Hh          , Mm          , Mm          , Mm          , Mm          , Mm          , Mm          , Mm          , Mm          , Hh          , Mm          , Hh          , Mm          , Mm          
Ss          , Ss          , Ss          , Gs^Ft       , Ds          , Wog         , Wog         , Wog         , Wog         , Wwg         , Wwrg        , Wwrg        , Wwg         , Wwg         , Wwrg        , Gs^Ft       , Gs^Ft       , Gs^Ft       , Gs^Ft       , Ss          , Gs^Ft       , Ss          , Hh          , Ss          , Co          , 1 Ko        , Co          , Gs^Ft       , Gs^Ft       , Hh          , Hh          , Hh          , Hh          , Hh          , Hh          , Mm          , Mm          , Mm          , Mm          , Mm          , Mm          , Mm          , Mm          , Hh          , Hh          , Hh          , Hh          , Hh          , Hh          , Gs^Ft       
Ss          , Gs^Ft       , Ss          , Gs^Ft       , Ds          , Wog         , Wog         , Wog         , Wog         , Wwg         , Wwg         , Wwg         , Wwg         , Wwg         , Wwg         , Wwrg        , Wwrg        , Gs^Ft       , Ss          , Ss          , Gs^Ft       , Hh          , Hh          , Hh          , Co          , Co          , Co          , Gs          , Gs          , Gs          , Hh^Vo       , Hh          , Hh          , Mm          , Mm          , Mm          , Mm          , Mm          , Mm          , Mm          , Mm          , Hh          , Hh          , Hh          , Hh          , Gs^Ft       , Hh          , Gs^Ft       , Wwg         , Wwg         
Ss          , Ss          , Ss          , Gs^Ft       , Gs^Ft       , Wog         , Wog         , Wog         , Wog         , Wog         , Wog         , Wwg         , Wwg         , Wwg         , Wwrg        , Wwg         , Wwg         , Wwg         , Wwg         , Ss          , Gs^Ft       , Hh^Vo       , Gs          , Gs          , Gs          , Gs          , Gs          , Gs          , Gs          , Gs          , Hh          , Hh          , Hh          , Hh          , Hh          , Hh          , Mm          , Hh          , Hh          , Hh          , Hh^Vhh      , Gs^Ft       , Hh          , Gs^Ft       , Gs^Ft       , Ss          , Wwg         , Wwg         , Wwg         , Wwg         
Gs^Ft       , Ss          , Gs^Ft       , Ss          , Gs^Ft       , Gs^Ft       , Wwg         , Wog         , Wog         , Wog         , Wog         , Wog         , Wwg         , Wwrg        , Wwrg        , Wwg         , Wwg         , Wwrg        , Wwg         , Gs^Ft       , Hh          , Hh          , Gs          , Gs          , Gs          , Gs          , Gs          , Gs          , Gs          , Gs          , Gs^Ft       , Gs^Ft       , Gs^Ft       , Gs^Ft       , Gs^Ft       , Hh          , Hh          , Hh          , Hh          , Gs^Ft       , Gs^Ft       , Ss          , Gs^Ft       , Ss          , Wwg         , Wwg         , Wwg         , Wwg         , Hh          , Hh          
Gs^Ft       , Gs^Ft       , Gs^Ft       , Ss          , Ss          , Ss          , Gs^Ft       , Wwg         , Wog         , Wog         , Wog         , Wog         , Wwg         , Wwrg        , Wwrg        , Wwrg        , Wwg         , Wwg         , Wwg         , Wwrg        , Hh          , Wwrg        , Wwf         , Wwf         , Wwf         , Wwf         , Wwf         , Gs^Ft       , Wwf         , Gs          , Gs^Ft       , Ss          , Gs^Ft       , Ss          , Gs^Ft       , Gs^Ft       , Gs^Ft       , Gs^Ft       , Gs^Ft       , Gs^Ft       , Wwg         , Wwg         , Wwg         , Wwg         , Wwg         , Wwg         , Hh          , Gs^Ft       , Hh          , Mm          
Gs^Ft       , Gs^Ft       , Ss^Vhs      , Ss          , Gs^Ft       , Gs^Ft       , Gs^Ft       , Wwg         , Wog         , Wog         , Wog         , Wwrg        , Wwg         , Wwg         , Wwg         , Wwg         , Wog         , Wwg         , Wwg         , Wwg         , Wog         , Wwf         , Wwf         , Wwg         , Wwf         , Wwf         , Wwg         , Wwf         , Wwrg        , Wwf         , Wwf         , Wwrg        , Wwrg        , Wwg         , Wwg         , Wwg         , Wwg         , Wwg         , Wwg         , Wwg         , Wwg         , Wwg         , Wwg         , Wwg         , Wwg         , Wwg         , Wwg         , Gs^Ft       , Gs^Ft       , Hh          
Gs^Ft       , Gs^Ft       , Ss          , Gs^Ft       , Gs^Ft       , Ss^Vhs      , Gs^Ft       , Wwg         , Wog         , Wog         , Wog         , Wwrg        , Wwg         , Wwrg        , Wwrg        , Wwrg        , Wog         , Wog         , Wog         , Wog         , Wog         , Wwf         , Wwrg        , Wwf         , Wwf         , Wwg         , Wwf         , Wwrg        , Wwf         , Wwg         , Wwf         , Wwrg        , Wwrg        , Wwg         , Wwg         , Wwg         , Wwg         , Wwg         , Wwg         , Wwg         , Wwg         , Wwg         , Wwg         , Wwg         , Wwg         , Wwg         , Wwg         , Wwg         , Wwg         , Gs^Ft       
Gs^Ft       , Ss          , Ss          , Gs^Ft       , Gs^Ft       , Ss          , Gs^Ft       , Wwg         , Wog         , Wog         , Wog         , Wwg         , Wwrg        , Wwrg        , Hh          , Hh          , Ss          , Wog         , Wog         , Wog         , Wog         , Wwrg        , Wwf         , Wwrg        , Wwf         , Wwrg        , Wwrg        , Wwf         , Wwrg        , Wwrg        , Wwf         , Wwrg        , Wwrg        , Wwg         , Wwg         , Wwg         , Wwg         , Wwg         , Gs^Ft       , Wwg         , Gs^Vo       , Gs^Ft       , Hh          , Gs^Ft       , Gs^Ft       , Gs^Ft       , Ss          , Wwg         , Wwg         , Wwg         
Gs^Ft       , Gs^Ft       , Ss          , Ss          , Wwg         , Wwg         , Wog         , Wog         , Wog         , Wog         , Wog         , Wwg         , Wwg         , Hh          , Hh          , Ss          , Ss          , Hh          , Hh          , Wog         , Hh          , Wwf         , Wwf         , Wwf         , Wwf         , Wwf         , Wwf         , Wwf         , Wwf         , Wwf         , Wwf         , Wwf         , Wwf         , Wwrg        , Gs^Ft       , Gs^Ft       , Gs^Ft       , Gs^Ft       , Gs^Edpp     , Gs^Edpp     , Gs^Edpp     , Gs^Edp      , Gs^Es       , Hh          , Hh          , Ss          , Gs^Ft       , Hh          , Hh          , Wwg         
Gs^Ft       , Gs^Ft       , Wwg         , Wwg         , Wog         , Wog         , Wog         , Wog         , Wog         , Wog         , Wwg         , Wwg         , Wwg         , Hh^Vo       , Hh          , Hh^Fds      , Hh^Fds      , Hh          , Rb^Es       , Hh          , Rb^Em       , Hh          , Hh          , Gs^Edpp     , Gs^Edpp     , Gs^Edpp     , Gs^Edpp     , Gs^Vo       , Gs^Edpp     , Wwf         , Wwf         , Wwf         , Gs^Edpp     , Gs^Edpp     , Gs^Edpp     , Gs^Edpp     , Gd^Edp      , Gs^Edpp     , Gs^Edpp     , Hh          , Gs^Edpp     , Gs^Edpp     , Gs^Edpp     , Gs^Ft       , Hh          , Hh          , Mm          , Gs^Ft       , Mm          , Gs^Ft       
Gs^Ft       , Wwg         , Wog         , Wog         , Wog         , Wog         , Wog         , Wog         , Wwg         , Wwg         , Wwg         , Wwg         , Ds          , Hh          , Mm          , Rb^Es       , Hh          , Rb^Es       , Hh          , Hh          , Hh          , Hh          , Hh          , Hh          , Gs^Edpp     , Gs^Edpp     , Gd^Edp      , Gs^Edpp     , Gs^Edpp     , Gs^Edpp     , Gs^Edpp     , Gs^Edpp     , Gs^Edpp     , Gs^Edpp     , Gs^Edpp     , Gd^Edp      , Gd^Edp      , Gd^Edp      , Gd^Edp      , Gs^Edpp     , Gs^Edpp     , Gs^Edpp     , Gd^Edp      , Gs^Edpp     , Hh          , Hh          , Mm          , Mm          , Mm          , Mm          
Wog         , Wog         , Wog         , Wog         , Wog         , Wog         , Wwg         , Wwg         , Wwg         , Wwg         , Ds          , Ds          , Gs^Fds      , Hh          , Hh^Fds      , Rb^Es       , Hh          , Rb^Es       , Hh          , Hh          , Hh          , Gs^Ft       , Gs^Ft       , Hh          , Gs^Edpp     , Gd^Edp      , Gs^Edpp     , Gs^Edpp     , Gs          , Gs^Edpp     , Gs          , Gs^Edpp     , Gs^Edpp     , Gs^Vo       , Gs^Edpp     , Gs^Edpp     , Gs^Edpp     , Gs^Edpp     , Gs^Edpp     , Gs^Edpp     , Hh          , Gs^Edpp     , Hh          , Hh          , Mm          , Mm          , Hh          , Mm          , Hh          , Mm          
Wog         , Wog         , Wog         , Wog         , Wwg         , Wwg         , Wwg         , Wwg         , Ss          , Ss          , Gs^Fds      , Gs^Fds      , Gs^Fds      , Gs^Fds      , Gs^Fds      , Hh^Fds      , Hh          , Hh          , Hh^Fds      , Hh          , Hh          , Hh^Vo       , Gs^Ft       , Gs^Ft       , Gs^Edpp     , Gs^Edpp     , Gs          , Gs          , Gs          , Gs          , Hh          , Gs^Edpp     , Gs^Edpp     , Gs^Edpp     , Hh          , Hh          , Hh          , Hh          , Hh          , Hh          , Hh          , Hh          , Hh          , Mm          , Hh          , Hh          , Gs^Es       , Hh          , Gs^Edpp     , Gs^Es       
Wog         , Wog         , Wog         , Wog         , Wwg         , Wwg         , Ds          , Ds          , Gs^Fds      , Ss          , Ss          , Re^Gvs      , Re^Gvs      , Gs^Fds      , Re^Gvs      , Hh^Vo       , Hh          , Rb^Es       , Hh          , Mm          , Mm          , Hh          , Gs^Es       , Gs^Edpp     , Gs          , Gs          , Gd          , Gd          , Gd          , Gs          , Gs^Es       , Gs^Es       , Gs^Es       , Gs^Ft       , Gs^Ft       , Hh          , Rb          , Hh          , Rb          , Hh          , Rb          , Hh          , Hh          , Hh          , Gs^Edpp     , Gs^Edpp     , Gs^Edpp     , Gs^Edpp     , Gs^Edpp     , Gs^Edpp     
Wog         , Wog         , Wog         , Wog         , Wwg         , Ds          , Ds          , Ds          , Gs^Fds      , Gs^Fds      , Gs^Fds      , Ss          , Ss          , Re^Gvs      , Re^Gvs      , Re^Gvs      , Hh          , Rb^Es       , Hh          , Mm          , Hh          , Hh          , Hh          , Gs^Edpp     , Gs          , Gd          , Gs          , Gs          , Gs          , Gs          , Rb          , Gs^Es       , Rb          , Rb          , Rb          , Rb          , Hh          , Rb          , Hh          , Rb          , Gs^Es       , Rb          , Rb          , Rb          , Rb          , Rb          , Rb          , Gd^Edp      , Rb          , Gs^Edpp     
Wog         , Wog         , Wog         , Wog         , Wwg         , Ds          , Gs^Fds      , Gs^Fds      , Re^Gvs      , Re^Gvs      , Re^Gvs      , Re^Gvs      , Ss          , Ss          , Ss          , Re^Gvs      , Re^Gvs      , Hh          , Hh          , Hh          , Hh          , Hh          , Gs^Es       , Gs          , Gs          , Gs          , Rb          , Rb          , Rb          , Rb          , Gs^Vo       , Rb          , Hh          , Hh          , Hh          , Hh          , Gs^Es       , Hh          , Gd          , Gs^Es       , Gd          , Gs^Es       , Gs          , Gs^Edpp     , Gs          , Gd^Edp      , Gd^Edp      , Rb          , Gd          , Rb          
Wog         , Wog         , Wog         , Wog         , Wwg         , Ds          , Gs^Fds      , Gs^Fds      , Re^Gvs      , Re^Gvs      , Ss          , Ss          , Re^Gvs      , Re^Gvs      , Re^Gvs      , Ss          , Ss          , Re^Gvs      , Re^Gvs      , Hh          , Hh^Vo       , Gs^Edpp     , Gs^Edpp     , Gs          , Rb          , Rb          , Gs          , Rb          , Gs          , Gs          , Gd          , Rb          , Rb          , Hh          , Gd          , Gs^Es       , Gd          , Gd          , Gs          , Gd          , Gs          , Gs          , Hh          , Hh          , Hh          , Gs          , Gs          , Gd^Edp      , Gd^Edp      , Gd^Edp      
Wog         , Wog         , Wog         , Wog         , Wwg         , Ds          , Gs^Fds      , Re^Gvs      , Ss          , Ss          , Re^Gvs      , Re^Gvs      , Rb          , Rb          , Rb          , Co          , Ss          , Ss          , Ss          , Re^Gvs      , Rb          , Gs^Edpp     , Rb          , Rb          , Gs          , Gs          , Gd          , Hh          , Gd          , Gd          , Gd          , Gd          , Gd          , Rb          , Rb          , Gd          , Hh          , Gs^Ft       , Hh          , Gs          , Gs          , Hh          , Hh          , Mm          , Mm          , Hh          , Hh          , Gs          , Gs^Es       , Gd^Edp      
Wog         , Wog         , Wog         , Wog         , Wwg         , Ds          , Co          , Re^Gvs      , Re^Gvs      , Re^Gvs      , Rb          , Rb          , Re^Gvs      , Re^Gvs      , Ss          , Ss^Bw\      , Rb          , Re^Gvs      , Rb          , Ss^Bw/      , Ss          , Rb          , Gs^Edpp     , Gs^Edpp     , Gs^Edpp     , Gd          , Gs^Edpp     , Gd          , Gs          , Gs^Es       , Gs^Es       , Gs          , Gs^Edpp     , Gd          , Gs^Vo       , Rb          , Gs^Edpp     , Hh          , Gs^Edpp     , Gs          , Gd^Edpp     , Gs          , Gs^Edpp     , Hh          , Mm          , Mm          , Mm          , Hh          , Hh          , Gs          
Wog         , Wog         , Wog         , Wog         , Wwg         , Co          , Rb^Vo       , Co          , Rb          , Rb          , Re^Gvs      , Re^Gvs      , Ss          , Ss          , Re^Gvs      , Re^Gvs      , Re^Gvs      , Rb          , Re^Gvs      , Re^Gvs      , Ss          , Ss          , Gs^Edpp     , Gs^Edpp     , Gs^Edpp     , Gs^Edpp     , Gs^Edpp     , Gs^Edpp     , Gs^Es       , Gs^Es       , Gs^Es       , Gs^Edpp     , Gs^Edpp     , Gs^Edpp     , Gs^Edpp     , Rb          , Gs^Edpp     , Gs^Edpp     , Gs^Edpp     , Gs^Edpp     , Gs^Edpp     , Gs^Edpp     , Gs^Edpp     , Hh          , Hh          , Mm          , Mm          , Mm          , Mm          , Hh          
Wog         , Wog         , Wog         , Wog         , Wwg         , Co          , Rb^Vo       , Rb          , Rb          , Co          , Co          , Re^Gvs      , Re^Gvs      , Re^Gvs      , Re^Gvs      , Re^Gvs      , Re^Gvs      , Re^Gvs      , Ss          , Ss          , Gs^Edpp     , Gs^Edpp     , Gs^Edpp     , Gs^Edpp     , Gs^Edpp     , Gs^Edpp     , Gs^Edpp     , Gs^Edpp     , Hh          , Hh          , Hh          , Gs^Edpp     , Gs^Ft       , Gs^Edpp     , Gs^Edpp     , Rb          , Gs^Edpp     , Gs^Edpp     , Gs^Ft       , Gs^Edpp     , Gs^Ft       , Gs^Ft       , Gs^Ft       , Hh          , Hh^Vo       , Hh          , Hh          , Mm          , Mm          , Hh          
Wog         , Wog         , Wog         , Wog         , Wwg         , Wwg         , Wwg         , Rb          , Rb          , Rb^Vo       , 2 Ko        , Co          , Re^Gvs      , Re^Gvs      , Rb^Gvs      , Rb^Gvs      , Ss          , Ss          , Hh^Fds      , Gs^Fds      , Gs^Fds      , Gs^Edpp     , Gs^Fds      , Gs^Fds      , Gs^Fds      , Gs^Fds      , Gs^Fds      , Gs^Edpp     , Hh          , Mm          , Hh          , Gs^Ft       , Gs^Ft       , Gs^Ft       , Gs^Edpp     , Rb          , Rb          , Gs^Edpp     , Gs^Edpp     , Gs^Ft       , Gs^Ft       , Gs^Ft       , Gs^Ft       , Gs^Ft       , Gs^Ft       , Hh          , Hh          , Hh          , Hh          , Mm          
Wog         , Wog         , Wog         , Wog         , Wwg         , Wwg         , Wwg         , Wwg^Bw/     , Rb^Vo       , Rb          , Rb^Vo       , Co          , Gs^Fds      , Rb^Gvs      , Hh^Fds      , Ss          , Hh^Fds      , Hh^Fds      , Hh^Fds      , Gs^Fds      , Gs^Fds      , Gs^Fds      , Hh^Fds      , Gs^Fds      , Hh^Fds      , Hh^Fds      , Hh^Fds      , Hh          , Mm          , Mm          , Hh          , Gs^Ft       , Gs^Ft       , Gs^Ft       , Gs^Edpp     , Gs^Edpp     , Gs^Edpp     , Rb          , Gs^Edpp     , Gs^Edpp     , Gs^Edpp     , Gs^Ft       , Gs^Ft       , Gs^Ft       , Gs^Ft       , Gs^Ft       , Gs^Ft       , Hh          , Hh          , Hh          
Wog         , Wog         , Wog         , Wog         , Wwg         , Wwg         , Wwg         , Wwg         , Co          , Rb          , Co          , Co          , Gs^Fds      , Hh^Fds      , Hh^Fds      , Hh^Fds      , Hh^Fds      , Hh^Fds      , Hh^Fds      , Hh^Fds      , Hh^Fds      , Hh^Fds      , Hh^Fds      , Hh^Fds      , Hh^Fds      , Hh^Fds      , Hh          , Hh          , Mm          , Mm          , Mm          , Hh          , Hh          , Gs^Ft       , Gs^Ft       , Gs^Edpp     , Gs^Edpp     , Rb          , Gs^Edpp     , Gs^Edpp     , Gs^Edpp     , Gs^Edpp     , Gs^Edpp     , Gs^Ft       , Gs^Ft       , Gs^Ft       , Gs^Ft       , Gs^Ft       , Gs^Ft       , Hh          
