border_size=1
usage=map

Gs^Ft       , Gs^Ft       , Gs^Ft       , Gs^Ft       , Gs^Ft       , Gs^Ft       , Gs^Ft       , Gs^Ft       , Gs^Ft       , Gs^Ft       , Gs^Ft       , Gs^Ft       , Gs^Ft       , Gs^Ft       , Gs^Ft       , Gs^Ft       , Gs^Ft       , Gs^Ft       , Gs^Ft       , Gs^Ft       , Gs^Ft       , Gs^Ft       , Gs^Ft       , Gs^Ft       , Rb^Ft       , Rb          , Gs^Ft       , Gs^Ft       , Gs^Ft       , Gs^Ft       , Gs^Ft       , Gs^Ft       , Rb^Ft       , Gs^Ft       , Gs^Ft       , Rb          , Gs^Ft       , Gs^Ft       , Rb^Ft       , Gs^Ft       , Gs^Ft       , Gs^Ft       , Gs^Ft       , Hh          , Hh          , Hh          
Rb^Ft       , Gs^Ft       , Gs^Ft       , Gs^Ft       , Gs^Ft       , Gs^Ft       , Gs^Ft       , Gs^Ft       , Gs^Ft       , Gs^Ft       , Gs^Ft       , Gs^Ft       , Gs^Ft       , Gs^Ft       , Gs^Ft       , Gs^Ft       , Gs^Ft       , Gs^Ft       , Gg^Fet      , Gs^Ft       , Gs^Ft       , Gs^Ft       , Gs^Ft       , Rb^Ft       , Rb          , Rb^Ft       , Gs^Ft       , Gs^Ft       , Gs^Ft       , Gs^Ft       , Gs^Ft       , Rb^Ft       , Rb^Ft       , Rb^Ft       , Gs^Ft       , Rb          , Gs^Ft       , Gs^Ft       , Rb^Ft       , Gs^Ft       , Rb^Ft       , Gs^Ft       , Gs^Ft       , Hh          , Hh          , Hh          
Gs^Ft       , Rb^Ft       , Gs^Ft       , Gs^Ft       , Gs^Ft       , Rb          , Gs^Ft       , Gs^Ft       , Gs^Ft       , Gs^Ft       , Chr         , Gs^Ft       , Gs^Ft       , Gs^Ft       , Gs^Ft       , Gs^Ft       , Gg^Fet      , Gs^Ft       , Gg^Emf      , Gg^Emf      , Gg^Emf      , Gg^Fet      , Rb^Ft       , Rb^Ft       , Gs^Ft       , Gs^Ft       , Rb^Em       , Gs^Ft       , Gs^Ft       , Gs^Ft       , Gs^Ft       , Gs^Ft       , Rb^Ft       , Gs^Ft       , Gs^Ft       , Rb          , Rb^Ft       , Rb^Ft       , Rb^Ft       , Rb^Ft       , Gs^Ft       , Gs^Ft       , Gs^Ft       , Gs^Ft       , Gs^Ft       , Hh          
Gs^Ft       , Rb^Ft       , Rb^Ft       , Gs^Ft       , Gs^Ft       , Gs^Ft       , Gs^Ft       , Gs^Ft       , Gs^Ft       , Chr         , 2 Khr       , Chr         , Rb          , Rb          , Gs^Ft       , Gs^Ft       , Gg^Emf      , Gg^Emf      , Gg^Xo       , Gg^Xo       , Gg^Xo       , Gg^Emf      , Gg^Emf      , Gs^Ft       , Gs^Ft       , Rb^Em       , Gs^Ft       , Gs^Ft       , Gs^Ft       , Rb^Ft       , Rb^Ft       , Gs^Ft       , Gs^Ft       , Gs^Ft       , Gs^Ft       , Rb          , Gs^Ft       , Rb^Ft       , Gs^Ft       , Rb^Ft       , Gs^Ft       , Gs^Ft       , Gs^Ft       , Hh          , Hh          , Hh          
Gs^Ft       , Gs^Ft       , Rb^Ft       , Gs^Ft       , Gs^Ft       , Rb          , Gs^Ft       , Gs^Ft       , Gs^Ft       , Chr         , Chr         , Chr         , Gs^Ft       , Gs^Ft       , Rb^Em       , Rb          , Gg^Emf      , Gg^Xo       , Co          , Co          , Co          , Gg^Xo       , Gg^Emf      , Gg^Fet      , Gs^Ft       , Gs^Ft       , Gs^Ft       , Gs^Ft       , Gs^Ft       , Gs^Ft       , Gs^Ft       , Rb^Ft       , Gs^Ft       , Gs^Ft       , Rb          , Rb          , Gs^Ft       , Gs^Ft       , Gs^Ft       , Gs^Ft       , Gs^Ft       , Gs^Ft       , Gs^Ft       , Gs^Ft       , Hh          , Hh          
Gs^Ft       , Gs^Ft       , Gs^Ft       , Rb          , Rb^Ft       , Gs^Ft       , Gs^Ft       , Gs^Ft       , Gs^Ft       , Gs^Ft       , Gs^Ft       , Gs^Ft       , Rb^Ft       , Gs^Ft       , Rb^Ft       , Rb^Ft       , Gg^Emf      , Gg^Xo       , Co          , 5 Ko        , Co          , Gg^Xo       , Gg^Emf      , Gs^Ft       , Gs^Ft       , Gs^Ft       , Gs^Ft       , Gs^Ft       , Gg^Fet      , Gs^Ft       , Gs^Ft       , Rb^Ft       , Rb          , Rb          , Gs^Ft       , Gs^Ft       , Gs^Ft       , Gs^Ft       , Gs^Ft       , Gs^Ft       , Gs^Ft       , Gs^Ft       , Rb^Ft       , Gs^Ft       , Hh          , Hh          
Gs^Ft       , Gs^Ft       , Gs^Ft       , Gs^Ft       , Gs^Ft       , Rb^Ft       , Rb^Ft       , Gs^Ft       , Gs^Ft       , Gs^Ft       , Gs^Ft       , Rb^Ft       , Sm          , Rb^Ft       , Gs^Ft       , Gg^Fet      , Gg^Emf      , Gg^Xo       , Gg^Xo       , Co          , Gg^Xo       , Gg^Xo       , Gg^Emf      , Gg^Fet      , Gs^Ft       , Gs^Ft       , Gs^Ft       , Gs^Ft       , Gs^Ft       , Gs^Ft       , Rb          , Rb          , Gs^Ft       , Rb^Ft       , Chs         , Gs^Ft       , Gs^Ft       , Gs^Ft       , Gs^Ft       , Rb^Ft       , Gs^Ft       , Gs^Ft       , Rb^Ft       , Gs^Ft       , Gs^Ft       , Hh          
Gs^Ft       , Gs^Ft       , Gs^Ft       , Gs^Ft       , Gs^Ft       , Gs^Ft       , Gs^Ft       , Rb^Ft       , Rb          , Rb          , Rb          , Rb^Ft       , Rb^Ft       , Rb^Ft       , Gs^Ft       , Gs^Ft       , Gs^Ft       , Gg^Emf      , Gg^Emf      , Gg^Xo       , Gg^Emf      , Gg^Emf      , Gg^Fet      , Gs^Ft       , Gs^Ft       , Gs^Ft       , Gs^Ft       , Gs^Ft       , Rb          , Rb          , Gs^Ft       , Gs^Ft       , Gs^Ft       , Chs         , 3 Khs       , Chs         , Rb          , Gs^Ft       , Gs^Ft       , Rb^Ft       , Rb^Ft       , Gs^Ft       , Rb^Ft       , Gs^Ft       , Gs^Ft       , Hh          
Gs^Ft       , Gs^Ft       , Gs^Ft       , Gs^Ft       , Gs^Ft       , Gs^Ft       , Rb^Ft       , Rb^Vhs      , Gs^Ft       , Gs^Ft       , Gs^Ft       , Gs^Ft       , Gs^Ft       , Gs^Ft       , Gs^Ft       , Gs^Ft       , Gs^Ft       , Gg^Fet      , Gs^Ft       , Gg^Emf      , Gs^Ft       , Gs^Ft       , Gs^Ft       , Gs^Ft       , Gs^Ft       , Gs^Ft       , Ss          , Gs^Ft       , Rb          , Gs^Ft       , Gs^Ft       , Rb          , Gs^Ft       , Chs         , Chs         , Chs         , Gs^Ft       , Gs^Ft       , Rb^Ft       , Gs^Ft       , Gs^Ft       , Gs^Ft       , Gs^Ft       , Gs^Ft       , Gs^Ft       , Hh          
Rb^Ft       , Gs^Ft       , Gs^Ft       , Gg^Fet      , Rb^Ft       , Rb^Ft       , Gs^Ft       , Gs^Ft       , Gs^Ft       , Gs^Ft       , Gs^Ft       , Rb^Em       , Gs^Ft       , Gs^Ft       , Gs^Ft       , Gs^Ft       , Rb^Ft       , Gs^Ft       , Ss          , Gg^Fet      , Ss          , Gs^Ft       , Ss          , Ss          , Ss          , Ss          , Gs^Ft       , Ss          , Ss^Bw|      , Gs^Ft       , Ss          , Gs^Ft       , Gs^Ft       , Gs^Ft       , Ss          , Rb^Ft       , Gs^Ft       , Rb^Ft       , Gs^Ft       , Gs^Ft       , Gs^Ft       , Gs^Ft       , Gs^Ft       , Gs^Ft       , Gs^Ft       , Hh          
Sm          , Rb^Ft       , Rb^Ft       , Rb^Ft       , Gs^Ft       , Rb^Ft       , Gs^Ft       , Gs^Ft       , Gs^Ft       , Gg^Fet      , Gs^Ft       , Gs^Ft       , Gs^Ft       , Gs^Ft       , Ss          , Rb^Ft       , Ss          , Ss          , Ss          , Ss          , Rb^Ft       , Ss          , Rb^Ft       , Ss          , Gs^Ft       , Gs^Ft       , Gs^Ft       , Gs^Ft       , Rb          , Ss          , Ss          , Ss          , Ss          , Ss          , Gs^Ft       , Rb^Ft       , Rb          , Gs^Ft       , Gs^Ft       , Gg^Fet      , Gs^Ft       , Gs^Ft       , Rb^Ft       , Rb^Ft       , Rb^Ft       , Gs^Ft       
Rb^Ft       , Sm          , Sm          , Rb^Ft       , Rb^Ft       , Rb^Ft       , Rb^Ft       , Gs^Ft       , Gs^Ft       , Gs^Ft       , Ss          , Ss          , Ss          , Ss          , Ss          , Ss          , Gs^Ft       , Gs^Ft       , Gs^Ft       , Rb^Em       , Gs^Ft       , Gs^Ft       , Gs^Ft       , Gs^Ft       , Gs^Ft       , Gs^Ft       , Rb          , Rb          , Rb^Ft       , Ss          , Ss          , Ss          , Ss          , Gs^Ft       , Gs^Ft       , Gs^Ft       , Gs^Ft       , Rb          , Rb^Ft       , Gs^Ft       , Gs^Ft       , Gs^Ft       , Gs^Ft       , Rb^Ft       , Gs^Ft       , Rb^Ft       
Ss          , Rb^Ft       , Rb^Ft       , Sm          , Sm          , Sm          , Sm          , Rb^Ft       , Rb^Ft       , Rb^Ft       , Ss          , Ss          , Gs^Ft       , Gg^Fet      , Sm          , Rb^Ft       , Gs^Ft       , Hh          , Hh          , Gs^Ft       , Gs^Ft       , Rb          , Gs^Ft       , Gs^Ft       , Rb          , Rb          , Gs^Ft       , Gs^Ft       , Rb^Ft       , Sm          , Rb^Ft       , Gs^Ft       , Gs^Ft       , Ss          , Gs^Ft       , Gs^Ft       , Gs^Ft       , Gs^Ft       , Rb          , Gs^Ft       , Hh          , Gs^Ft       , Hh          , Rb^Vhs      , Gs^Ft       , Gs^Ft       
Ss          , Ss          , Ss          , Rb^Vhs      , Rb^Ft       , Rb^Em       , Rb^Ft       , Sm          , Ss^Bw\      , Ss          , Rb^Ft       , Gs^Ft       , Rb^Em       , Rb^Ft       , Sm          , Rb^Ft       , Rb^Ft       , Hh          , Gs^Ft       , Gs^Ft       , Gs^Ft       , Gs^Ft       , Rb          , Rb          , Rb^Ft       , Gs^Ft       , Gg^Fet      , Gs^Ft       , Rb^Ft       , Sm          , Rb^Ft       , Gs^Ft       , Gs^Ft       , Ss          , Ss          , Gs^Ft       , Gs^Ft       , Gs^Ft       , Rb          , Gs^Ft       , Gs^Ft       , Hh          , Hh          , Gs^Ft       , Gs^Ft       , Gs^Ft       
Ss          , Ss          , Ss          , Ss          , Ss          , Rb^Ft       , Ss          , Ss          , Gs^Ft       , Rb          , Rb          , Gs^Ft       , Rb^Ft       , Sm          , Rb^Ft       , Rb^Ft       , Gs^Ft       , Rb^Ft       , Rb^Em       , Rb          , Rb          , Rb          , Gs^Ft       , Gs^Ft       , Gs^Ft       , Rb^Ft       , Gs^Ft       , Rb^Ft       , Sm          , Sm          , Rb^Ft       , Gs^Ft       , Gs^Ft       , Ss          , Gs^Ft       , Gs^Ft       , Gs^Ft       , Hh          , Rb          , Rb^Ft       , Ss          , Gs^Ft       , Hh          , Gs^Ft       , Gs^Ft       , Gs^Ft       
Ss          , Ss          , Ss          , Ss          , Ss          , Ss^Bw|      , Sm          , Rb^Ft       , Gs^Ft       , Gs^Ft       , Rb          , Rb^Ft       , Gs^Ft       , Rb^Ft       , Gs^Ft       , Gs^Ft       , Rb          , Rb          , Rb          , Gs^Ft       , Gs^Ft       , Gs^Ft       , Gs^Ft       , Hh          , Gs^Ft       , Rb^Ft       , Rb^Ft       , Rb^Ft       , Sm          , Rb^Ft       , Gs^Ft       , Gg^Fet      , Gs^Ft       , Ss          , Ss          , Gs^Ft       , Gs^Ft       , Hh          , Hh          , Sm          , Sm          , Rb^Ft       , Hh          , Hh          , Gs^Ft       , Gs^Ft       
Ss          , Ss          , Gs^Ft       , Gs^Ft       , Gs^Ft       , Rb          , Sm          , Rb^Ft       , Rb^Ft       , Gs^Ft       , Gs^Ft       , Rb          , Gs^Ft       , Gs^Ft       , Rb          , Rb          , Rb^Es       , Gs^Ft       , Gs^Ft       , Rb          , Rb          , Gs^Ft       , Gs^Ft       , Gs^Ft       , Gs^Ft       , Rb^Ft       , Sm          , Sm          , Rb^Ft       , Rb^Ft       , Gs^Ft       , Gs^Ft       , Gs^Ft       , Ss          , Ss          , Gs^Ft       , Gs^Ft       , Gs^Ft       , Rb^Ft       , Rb          , Rb          , Rb^Ft       , Gs^Ft       , Gs^Ft       , Gs^Ft       , Gs^Ft       
Gs^Ft       , Ss          , Rb^Ft       , Gs^Ft       , Rb          , Rb          , Rb^Ft       , Sm          , Rb^Em       , Gs^Ft       , Gs^Ft       , Rb          , Rb          , Gs^Ft       , Rb          , Hh          , Gs^Ft       , Rb^Vhs      , 4 Khs       , Gs^Ft       , Gs^Ft       , Rb          , Rb          , Gs^Ft       , Gs^Ft       , Rb^Ft       , Sm          , Sm          , Rb^Ft       , Gs^Ft       , Gs^Ft       , Gs^Ft       , Gs^Ft       , Ss          , Gs^Ft       , Gs^Ft       , Rb^Ft       , Rb^Ft       , Gs^Ft       , Gs^Ft       , Gs^Ft       , Rb          , Gs^Ft       , Rb^Ft       , Rb^Ft       , Gs^Ft       
Rb^Ft       , Rb^Ft       , Hh          , Rb^Ft       , Rb          , Gs^Ft       , Gg^Fet      , Sm          , Rb^Em       , Gs^Ft       , Rb^Vhs      , Rb^Ft       , Gs^Ft       , Rb          , Gs^Ft       , Hh          , Chs         , Chs         , Hh          , Chs         , Chs         , Gs^Ft       , Gs^Ft       , Rb          , Rb          , Rb^Em       , Sm          , Rb^Em       , Gs^Ft       , Gs^Ft       , Gs^Ft       , Ss          , Ss          , Ss          , Ss          , Ss^Vhs      , Gs^Ft       , Gs^Ft       , Gs^Ft       , Gs^Ft       , Gs^Ft       , Rb          , Rb          , Gs^Ft       , Gs^Ft       , Gs^Ft       
Gs^Ft       , Gs^Ft       , Hh          , Hh^Vo       , Rb          , Gs^Ft       , Sm          , Sm          , Rb^Ft       , Hh          , Gs^Ft       , Gs^Ft       , Gs^Ft       , Rb          , Rb^Ft       , Rb^Ft       , Ss          , Hh          , Ss          , Hh          , Hh          , Gs^Ft       , Gs^Ft       , Gs^Ft       , Gs^Ft       , Rb^Em       , Sm          , Rb^Ft       , Gs^Ft       , Gs^Ft       , Rb^Ft       , Rb^Ft       , Ss          , Ss          , Ss          , Ss          , Ss          , Ss          , Ss          , Gs^Ft       , Gs^Ft       , Gs^Ft       , Rb          , Gs^Ft       , Gs^Ft       , Gs^Ft       
Gs^Ft       , Hh          , Gs^Ft       , Gs^Ft       , Rb          , Rb^Ft       , Sm          , Rb^Ft       , Gs^Ft       , Hh          , Gs^Ft       , Gs^Ft       , Rb^Ft       , Sm^Bw|      , Sm          , Rb^Ft       , Sm          , Ss          , Hh          , Hh          , Rb^Em       , Gs^Ft       , Gg^Fet      , Gs^Ft       , Gs^Ft       , Rb^Ft       , Sm          , Rb^Ft       , Rb^Vhs      , Rb^Ft       , Ss          , Ss          , Ss          , Ss          , Rb^Ft       , Ss          , Rb^Ft       , Ss          , Gs^Ft       , Ss          , Gs^Ft       , Gs^Ft       , Rb^Ft       , Rb^Vhs      , Gs^Ft       , Gs^Ft       
Gs^Ft       , Gs^Ft       , Rb^Ft       , Gs^Ft       , Rb          , Rb^Ft       , Sm          , Rb^Ft       , Hh          , Gs^Ft       , Rb^Ft       , Rb^Ft       , Sm          , Sm^Bw|      , Ur          , Sm          , Sm          , Hh          , Hh          , Gs^Ft       , Rb          , Gs^Ft       , Gs^Ft       , Gs^Ft       , Gs^Ft       , Rb^Ft       , Sm          , Rb^Ft       , Gs^Ft       , Rb^Ft       , Ss          , Rb^Ft       , Rb^Ft       , Rb^Ft       , Rb^Ft       , Rb^Ft       , Gs^Ft       , Gs^Ft       , Gs^Ft       , Gs^Ft       , Gs^Ft       , Gs^Ft       , Rb^Ft       , Gs^Ft       , Gs^Ft       , Gs^Ft       
Rb^Ft       , Rb^Ft       , Rb^Ft       , Rb^Ft       , Sm^Bw|      , Rb^Ft       , Sm          , Sm          , Sm          , Hh          , Sm          , Rb^Ft       , Sm          , Sm^Bw|      , Sm          , Sm          , Rb^Ft       , Hh          , Gs^Ft       , Gs^Ft       , Rb^Vhs      , Rb^Ft       , Rb^Ft       , Gs^Ft       , Gs^Ft       , Rb^Ft       , Sm          , Rb^Ft       , Rb^Ft       , Rb^Ft       , Rb^Ft       , Ss          , Rb^Ft       , Rb^Vhs      , Gs^Ft       , Gs^Ft       , Gs^Ft       , Gs^Ft       , Gs^Ft       , Rb^Ft       , Rb^Ft       , Rb^Ft       , Gs^Ft       , Gs^Ft       , Gs^Ft       , Gs^Ft       
Sm          , Sm          , Sm          , Sm          , Rb          , Sm          , Rb^Ft       , Sm          , Sm          , Hh          , Hh          , Rb^Ft       , Rb^Em       , Sm^Bw|      , Rb          , Rb^Em       , Gs^Ft       , Gg^Fet      , Gs^Ft       , Gs^Ft       , Rb^Ft       , Sm          , Rb^Ft       , Gs^Ft       , Gs^Ft       , Rb^Ft       , Sm          , Sm          , Rb^Ft       , Gs^Ft       , Gg^Fet      , Rb^Ft       , Gs^Ft       , Rb^Ft       , Gs^Ft       , Gs^Ft       , Gs^Ft       , Gg^Fet      , Gs^Ft       , Rb^Ft       , Gs^Ft       , Gs^Ft       , Gs^Ft       , Gs^Ft       , Gs^Ft       , Gs^Ft       
Rb^Ft       , Rb^Ft       , Rb^Ft       , Rb^Vhs      , Rb          , Rb^Ft       , Gs^Ft       , Rb^Ft       , Sm          , Sm          , Sm          , Rb^Em       , Gs^Ft       , Gs^Ft       , Gs^Ft       , Rb          , Rb          , Gs^Ft       , Gs^Ft       , Gs^Ft       , Gs^Ft       , Rb^Ft       , Gs^Ft       , Gs^Ft       , Rb^Em       , Rb^Em       , Sm          , Rb^Ft       , Gs^Ft       , Gs^Ft       , Gs^Ft       , Gs^Ft       , Gs^Ft       , Gs^Ft       , Gs^Ft       , Gs^Ft       , Rb^Ft       , Gs^Ft       , Gs^Ft       , Rb^Ft       , Gs^Ft       , Gs^Ft       , Gs^Ft       , Gs^Ft       , Gs^Ft       , Gs^Ft       
Gs^Ft       , Rb^Ft       , Gs^Ft       , Gs^Ft       , Rb          , Gs^Ft       , Gs^Ft       , Rb^Ft       , Rb^Ft       , Sm          , Sm          , Rb^Ft       , Gs^Ft       , Gs^Ft       , Gg^Fet      , Gs^Ft       , Gs^Ft       , Rb          , Rb          , Gs^Ft       , Gs^Ft       , Rb^Ft       , Rb          , Rb          , Sm          , Sm          , Sm          , Rb^Ft       , Rb^Ft       , Gs^Ft       , Gs^Ft       , Gs^Ft       , Rb          , Gs^Ft       , Gs^Ft       , Rb^Vhs      , Rb^Ft       , Gs^Ft       , Gs^Ft       , Gs^Ft       , Gs^Ft       , Rb^Vhs      , Gs^Ft       , Gs^Ft       , Gs^Ft       , Gs^Ft       
Gs^Ft       , Gs^Ft       , Gs^Ft       , Rb          , Rb          , Gg^Fet      , Hh          , Gs^Ft       , Hh          , Rb^Ft       , Sm          , Rb^Ft       , Hh          , Hh          , Gs^Ft       , Gs^Ft       , Gs^Ft       , Gs^Ft       , Gs^Ft       , Rb          , Rb          , Rb          , Gs^Ft       , Gs^Ft       , Hh          , Sm          , Gg^Fet      , Sm          , Sm          , Rb^Ft       , Rb^Em       , Rb          , Gs^Ft       , Gs^Ft       , Gs^Ft       , Gs^Ft       , Rb^Ft       , Gs^Ft       , Hh          , Gs^Ft       , Hh          , Gs^Ft       , Gs^Ft       , Gs^Ft       , Hh          , Gs^Ft       
Gs^Ft       , Gs^Ft       , Rb^Ft       , Rb          , Gs^Ft       , Gs^Ft       , Gs^Ft       , Hh          , Rb          , Hh          , Sm          , Rb^Vhs      , Gs^Ft       , Hh          , Rb          , Gs^Ft       , Rb^Ft       , Rb^Vhs      , Rb^Ft       , Gs^Ft       , Rb          , Gs^Ft       , Rb^Ft       , Hh          , Hh^Vo       , Hh          , Gs^Ft       , Gs^Ft       , Rb          , Sm^Bw/      , Sm          , Gs^Ft       , Ss          , Gs^Ft       , Hh          , Hh          , Gs^Ft       , Rb^Ft       , Rb^Ft       , Hh          , Hh          , Hh          , Hh          , Hh          , Hh          , Hh          
Gs^Ft       , Gs^Ft       , Rb          , Rb          , Gs^Ft       , Rb^Ft       , Gs^Ft       , Gs^Ft       , Hh          , Hh          , Sm          , Rb^Ft       , Gs^Ft       , Gs^Ft       , Gs^Ft       , Gs^Ft       , Hh          , Gs^Ft       , Rb^Ft       , Gs^Ft       , Rb          , Gs^Ft       , Rb^Ft       , Rb^Ft       , Gs^Ft       , Gs^Ft       , Rb          , Rb          , Gs^Ft       , Gs^Ft       , Ss          , Ss          , Ss          , Hh          , Hh          , Gs^Ft       , Gs^Ft       , Gs^Ft       , Rb^Em       , Gs^Ft       , Gs^Ft       , Rb^Ft       , Rb^Ft       , Hh          , Hh          , Hh          
Rb          , Rb          , Rb^Ft       , Rb^Vhs      , Gs^Ft       , Gs^Ft       , Hh          , Hh          , Rb          , Hh          , Sm          , Gg^Fet      , Rb^Ft       , Gs^Ft       , Gs^Ft       , Gs^Ft       , Gs^Ft       , Hh          , Gs^Ft       , Rb^Ft       , Rb          , Rb^Ft       , Gs^Ft       , Gs^Ft       , Gs^Ft       , Rb          , Gs^Ft       , Gs^Ft       , Ss          , Ss          , Gs^Ft       , Hh          , Hh          , Ss          , Ss          , Ss          , Ss          , Gs^Ft       , Ss          , Gs^Ft       , Gs^Ft       , Rb^Ft       , Gs^Ft       , Hh^Vhs      , Hh          , Hh          
Gs^Ft       , Gs^Ft       , Rb^Ft       , Gs^Ft       , Gs^Ft       , Hh          , Gs^Ft       , Gs^Ft       , Rb          , Hh          , Rb^Ft       , Sm          , Sm          , Rb^Ft       , Rb          , Rb          , Gs^Ft       , Gs^Ft       , Gs^Ft       , Gs^Ft       , Rb          , Gs^Ft       , Gs^Ft       , Gs^Ft       , Gs^Ft       , Gs^Ft       , Ss          , Ss          , Rb^Ft       , Rb^Ft       , Gs^Ft       , Hh          , Gs^Ft       , Gs^Ft       , Gs^Ft       , Ss          , Ss          , Ss          , Ss          , Gs^Ft       , Gs^Ft       , Rb^Ft       , Gs^Ft       , Gs^Ft       , Hh          , Hh          
Gs^Ft       , Gs^Ft       , Rb^Ft       , Gs^Ft       , Gs^Ft       , Gs^Ft       , Gs^Ft       , Gs^Ft       , Gs^Vhs      , Rb          , Rb          , Rb^Ft       , Rb^Ft       , Sm          , Sm          , Rb^Ft       , Rb^Ft       , Gs^Ft       , Re^Vct      , Re^Vct      , Ce          , Re^Vct      , Re^Vct      , Gs^Ft       , Ss          , Ss          , Gs^Ft       , Gs^Ft       , Rb^Ft       , Gs^Ft       , Gg^Fet      , Rb^Vhs      , Gs^Ft       , Gs^Ft       , Rb^Ft       , Gs^Ft       , Gs^Ft       , Ss          , Ss          , Ss          , Ss          , Gs^Ft       , Gs^Ft       , Gs^Ft       , Hh          , Hh          
Gs^Ft       , Gs^Ft       , Rb^Vhs      , Gs^Ft       , Gg^Fet      , Gs^Ft       , Rb^Ft       , Rb^Ft       , Rb^Ft       , Gs^Ft       , Gs^Ft       , Rb          , Rb          , Rb^Em       , Rb^Vhs      , Sm          , Sm          , Sm          , Ce          , Ce          , 1 Ke        , Ce          , Ce          , Ss          , Rb^Em       , Gs^Ft       , Rb^Ft       , Rb^Ft       , Rb^Ft       , Gs^Ft       , Gs^Ft       , Gs^Ft       , Gs^Ft       , Gs^Ft       , Gs^Ft       , Rb^Ft       , Gs^Ft       , Gs^Ft       , Gs^Ft       , Ss          , Ss          , Ss          , Ss          , Gs^Ft       , Gs^Ft       , Hh          
Gs^Ft       , Gs^Ft       , Gs^Ft       , Gs^Ft       , Gs^Ft       , Gs^Ft       , Gs^Ft       , Gs^Ft       , Rb^Ft       , Gs^Ft       , Gs^Ft       , Gs^Ft       , Gs^Ft       , Gs^Ft       , Gs^Ft       , Rb^Ft       , Rb^Ft       , Sm          , Re^Vct      , Ce          , Rb          , Ce          , Re^Vct      , Ss          , Rb          , Re^Vo       , Gs^Ft       , Gs^Ft       , Gs^Ft       , Gs^Ft       , Gs^Ft       , Gs^Ft       , Hh          , Hh          , Hh          , Gs^Ft       , Hh          , Gs^Ft       , Gs^Ft       , Ss^Vhs      , Gs^Ft       , Ss          , Gs^Ft       , Ss          , Ss          , Gs^Ft       
Gs^Ft       , Gs^Ft       , Gs^Ft       , Gs^Ft       , Gs^Ft       , Gs^Ft       , Gs^Ft       , Gs^Ft       , Gs^Ft       , Gs^Ft       , Gs^Ft       , Gs^Ft       , Gs^Ft       , Gs^Ft       , Gs^Ft       , Rb^Ft       , Rb^Ft       , Sm          , Gs^Ft       , Gs^Ft       , Rb          , Gs^Ft       , Gs^Ft       , Ss          , Rb          , Gs^Ft       , Gs^Ft       , Gs^Ft       , Hh          , Hh          , Hh          , Hh          , Hh          , Hh          , Hh          , Hh          , Hh          , Hh          , Gs^Ft       , Gs^Ft       , Gs^Ft       , Gs^Ft       , Gs^Ft       , Gs^Ft       , Gs^Ft       , Ss          
