border_size=1
usage=map

Wwg         , Wwg         , Wwg         , Wwg         , Gs^Ft       , Hh          , Hh          , Hh          , Hh          , Hh          , Hh          , Hh          , Hh          , Hh          , Hh          , Hh          , Hh          , Hh          , Hh          , Hh          , Hh          , Hh          , Hh          , Hh          , Hh          , Hh          , Hh          , Hh          , Hh          , Hh          , Hh          , Hh          , Hh          , Hh          , Hh          , Hh          , Hh          , Hh          , Hh          , Hh          , Hh          , Hh          , Hh          , Hh          , Hh          
Wwg         , Wwg         , Wwg         , Wwg         , Gs^Ft       , Gs^Ft       , Gs^Ft       , Hh          , Hh          , Hh          , Hh          , Hh          , Hh^Vo       , Hh          , Hh          , Hh          , Hh          , Hh          , Hh          , Hh          , Hh          , Hh          , Hh          , Hh          , Hh          , Hh          , Hh          , Hh          , Hh          , Hh          , Hh          , Hh          , Hh          , Hh          , Hh          , Hh          , Hh          , Hh          , Hh          , Hh          , Hh          , Hh          , Hh          , Hh          , Hh          
Gs^Ft       , Wwg         , Wwg         , Wwg         , Wwg         , Gs^Ft       , Gs^Ft       , Gs^Ft       , Gs^Ft       , Gs^Ft       , Gs^Ft       , Gs^Ft       , Gs^Ft       , Gs^Ft       , Gs^Ft       , Hh          , Hh          , Hh          , Hh          , Hh          , Hh          , Hh          , Hh          , Hh          , Hh          , Hh          , Hh          , Hh          , Ss^Vhs      , Hh          , Gs^Ft       , Gs^Ft       , Gs^Ft       , Gs^Ft       , Gs^Ft       , Hh          , Gs^Ft       , Hh^Vhs      , Hh          , Hh          , Hh          , Hh          , Hh          , Hh          , Hh          
Gs^Ft       , Gs^Ft       , Gs^Ft       , Wwg         , Wwg         , Wwf         , Wwf         , Gs^Ft       , Gs^Ft       , Gs^Ft       , Rb          , Gs^Ft       , Rb          , Gs^Ft       , Rb          , Rb          , Gs^Ft       , Hh          , Gs^Ft       , Gs^Ft       , Gs^Ft       , Hh          , Gs^Ft       , Hh          , Hh          , Hh          , Hh          , Hh          , Ss          , Ss          , Ss          , Gs^Ft       , Ss          , Gs^Ft       , Gs^Ft       , Gs^Ft       , Gs^Ft       , Hh          , Hh          , Hh          , Hh          , Hh          , Hh          , Hh          , Hh          
Gs^Ft       , Gs^Ft       , Rb          , Rb^Vct      , Ce          , Wwf         , Wwf         , Wwf         , Wwf         , Rb          , Gs^Ft       , Rb          , Gs^Ft       , Rb          , Gs^Ft       , Rb          , Rb          , Gs^Ft       , Gs^Ft       , Gs^Ft       , Ss          , Rb^Ft       , Rb^Ft       , Gs^Ft       , Gs^Ft       , Hh          , Gs^Ft       , Gs^Ft       , Ss          , Gs^Ft       , Ss          , Ss          , Ss          , Ss          , Gs^Ft       , Gs^Ft       , Gs^Ft       , Gs^Ft       , Hh          , Hh          , Hh          , Hh          , Hh          , Hh          , Hh          
Gs^Ft       , Rb^Vct      , Rb          , Ce          , 1 Ke        , Ce          , Rb^Vct      , Wwf         , Wwg         , Wwg         , Wwg         , Gs^Ft       , Gs^Ft       , Gs^Ft       , Gs^Ft       , Gs^Ft       , Rb^Ft       , Rb          , Rb          , Gs^Ft       , Rb^Ft       , Gs^Ft       , Rb^Ft       , Rb^Ft       , Gs^Ft       , Gs^Ft       , Gs^Ft       , Gs^Ft       , Gs^Ft       , Ss          , Gs^Ft       , Gs^Ft       , Gs^Ft       , Ss          , Ss          , Gs^Ft       , Ss          , Gs^Ft       , Hh          , Hh          , Hh          , Hh^Vhs      , Hh          , Hh          , Hh          
Gs^Ft       , Gs^Ft       , Rb          , Ce          , Ce          , Ce          , Rb^Vct      , Gs^Ft       , Gs^Ft       , Wwg         , Wwg         , Wwg         , Wwg         , Gs^Ft       , Gs^Ft       , Rb^Vhs      , Gs^Ft       , Gs^Ft       , Gs^Ft       , Rb          , Rb          , Rb          , Rb          , Gs^Ft       , Rb          , Gs^Ft       , Gs^Ft       , Gs^Ft       , Gs^Ft       , Gs^Ft       , Gs^Ft       , Gs^Ft       , Rb^Ft       , Gs^Ft       , Ss          , Ss          , Ss          , Ss          , Ss          , Hh          , Hh          , Hh          , Hh          , Hh          , Hh          
Ce          , Ce          , Ce          , Rb^Gvs      , Rb^Gvs      , Rb^Gvs      , Gs^Ft       , Gs^Ft       , Gs^Ft       , Gs^Ft       , Gs^Ft       , Wwg         , Wwg         , Wwg         , Wwg         , Gs^Ft       , Ss          , Gs^Ft       , Gs^Ft       , Gs^Ft       , Gs^Ft       , Rb^Vhs      , Gs^Ft       , Rb          , Gs^Ft       , Rb          , Rb          , Rb          , Rb          , Gs^Ft       , Rb^Ft       , Rb^Ft       , Ss          , Ss          , Ss          , Ss          , Co          , Co          , Co          , Ss          , Ss          , Ss          , Ss          , Ss          , Ss          
Ce          , Ce          , Ce          , Rb^Vct      , Rb^Gvs      , Rb^Gvs      , Gs^Ft       , Gs^Ft       , Rb^Edp      , Gs^Ft       , Gs^Ft       , Gs^Ft       , Gs^Ft       , Wwg         , Wwg         , Wwg         , Wwg         , Wwg         , Wwg         , Gs^Ft       , Ss          , Gs^Ft       , Ss          , Gs^Ft       , Gs^Ft       , Rb^Ft       , Gs^Ft       , Gs^Ft       , Rb^Ft       , Rb^Ft       , Ss          , Ss          , Ss          , Ss          , Co          , Co          , Hhd         , Hhd         , Hhd         , Co          , Co          , Ss          , Ss          , Ss          , Ss          
Rb          , Ce          , 5 Ke        , Ce          , Rb^Gvs      , Rb^Gvs      , Rb^Vhs      , Gs^Ft       , Gs^Ft       , Rb^Edpp     , Rb^Edp      , Gs^Ft       , Ds          , Gs^Ft       , Gs^Ft       , Wwg         , Wwg         , Wog         , Wwg         , Wwg         , Wwg         , Ss          , Gs^Ft       , Gs^Ft       , Gs^Ft       , Rb^Vhs      , Gs^Ft       , Gs^Ft       , Ss          , Ss          , Ss          , Ss          , Co          , Co          , Hhd         , Hhd         , Co          , Co          , Co          , Hhd         , Hhd         , Co          , Co          , Ss          , Ss          
Rb          , Ce          , Ce          , Ce          , Rb^Gvs      , Rb^Gvs      , Gs^Ft       , Gs^Ft       , Gs^Ft       , Rb^Ft       , Rb^Ft       , Gs^Ft       , Gs^Ft       , Gs^Ft       , Gs^Ft       , Gs^Ft       , Gs^Ft       , Wwg         , Gs^Ft       , Wwg         , Wwg         , Wwg         , Wwg         , Gs^Ft       , Gs^Ft       , Gs^Ft       , Gs^Ft       , Gs^Ft       , Ss          , Ss          , Co          , Co          , Co          , Hhd         , Co          , Co          , Rb          , Rb          , Rb          , Co          , Co          , Hhd         , Co          , Ss          , Ss          
Gs^Ft       , Rb^Gvs      , Rb^Gvs      , Rb^Vct      , Rb^Gvs      , Rb^Gvs      , Gs^Ft       , Gs^Ft       , Gs^Ft       , Gs^Ft       , Rb^Ft       , Gs^Ft       , Rb^Vo       , Gs^Ft       , Hh          , Gs^Ft       , Rb^Edp      , Gs^Ft       , Gs^Ft       , Hh          , Hh          , Wwg         , Wwg         , Wwg         , Wwg         , Gs^Ft       , Ss          , Ss          , Ss          , Ss          , Co          , 4 Ko        , Co          , Hhd         , Co          , Rb          , Co          , Co          , Co          , Rb          , Co          , Hhd         , Co          , Gs^Ft       , Gs^Ft       
Gs^Ft       , Rb^Vct      , Gs^Ft       , Rb^Gvs      , Rb^Gvs      , Rb^Gvs      , Gs^Ft       , Ds          , Gs^Ft       , Gs^Ft       , Rb^Ft       , Rb^Ft       , Gs^Ft       , Gs^Ft       , Hh          , Rb^Edp      , Gs^Ft       , Rb^Edp      , Hh          , Hh          , Hh          , Ds          , Wwg         , Wwg         , Wwg         , Ss          , Gs^Ft       , Ss^Vhs      , Gs^Ft       , Ss          , Co          , Co          , Rb^Vo       , Hhd         , Co          , Rb          , Co          , 2 Ko        , Co          , Rb          , Co          , Hhd         , Co          , Gs^Ft       , Gs^Ft       
Gs^Ft       , Gs^Ft       , Gs^Ft       , Gs^Ft       , Gs^Ft       , Rb^Gvs      , Rb          , Gs^Ft       , Rb^Ft       , Rb^Ft       , Gs^Ft       , Gs^Ft       , Rb^Edp      , Rb^Edp      , Gs^Ft       , Gs^Ft       , Rb^Ft       , Rb^Ft       , Hh          , Hh          , Rb^Vhs      , Ds          , Ds          , Wwg         , Wwg         , Wwg         , Wwg         , Gs^Ft       , Gs^Ft       , Ss          , Co          , Rb^Vo       , Rb          , Hhd         , Co          , Rb          , Rb          , Co          , Rb          , Rb          , Co          , Hhd         , Co          , Gs^Ft       , Gs^Ft       
Gs^Ft       , Gs^Ft       , Gs^Ft       , Gs^Ft       , Gs^Ft       , Gs^Ft       , Rb^Vo       , Rb          , Rb          , Gs^Ft       , Rb^Edp      , Rb^Edp      , Hh          , Hh          , Gs^Ft       , Gs^Ft       , Gs^Ft       , Rb^Ft       , Hh          , Hh          , Gs^Ft       , Gs^Ft       , Gs^Ft       , Ds          , Ds          , Wwg         , Wwg         , Gs^Ft       , Ss          , Ss          , Co          , Rb^Vo       , Rb          , Hhd         , Hhd         , Co          , Ko          , Rb          , Ko          , Co          , Hhd         , Hhd         , Co          , Gs^Ft       , Gs^Ft       
Hh          , Gs^Ft       , Rb^Ft       , Gs^Ft       , Gs^Ft       , Gs^Ft       , Gs^Ft       , Rb^Edpp     , Gs^Ft       , Rb          , Rb          , Gs^Ft       , Hh          , Gs^Ft       , Gs^Ft       , Hh          , Hh          , Hh          , Hh          , Hh          , Gs^Ft       , Gs^Ft       , Gs^Ft       , Gs^Ft       , Ds          , Wwg         , Wwg         , Wwg         , Wwg         , Ss          , Co          , Rb^Vo       , Rb          , Rb^Vo       , Rb^Vo       , Hhd         , Hhd         , Rb          , Rb^Vo       , Hhd         , Hhd         , Hhd         , Co          , Gs^Ft       , Gs^Ft       
Hh          , Hh          , Rb^Ft       , Rb^Ft       , Hh          , Gs^Ft       , Gs^Ft       , Rb^Ft       , Gs^Ft       , Gs^Ft       , Rb^Edpp     , Rb          , Rb          , Gs^Ft       , Gs^Ft       , Gs^Ft       , Gs^Ft       , Gs^Ft       , Gs^Ft       , Gs^Ft       , Ds          , Gs^Ft       , Hh          , Gs^Ft       , Gs^Ft       , Ds          , Ds          , Wwg         , Wwg         , Wwg         , Co          , Rb^Vo       , Rb^Vo       , Rb          , Rb          , Rb^Vo       , Rb          , Rb          , Rb          , Rb^Vo       , Hhd         , 3 Ko        , Co          , Gs^Ft       , Wwg         
Hh          , Hh          , Hh          , Hh          , Gs^Ft       , Hh          , Rb^Ft       , Rb^Ft       , Gs^Ft       , Gs^Ft       , Rb^Ft       , Hh          , Hh          , Rb          , Rb          , Rb          , Rb          , Gs^Ft       , Gs^Ft       , Gs^Ft       , Gs^Ft       , Gs^Ft       , Gs^Ft       , Rb^Ft       , Gs^Ft       , Gs^Ft       , Hh          , Hh          , Wwg         , Wwg         , Wwg         , Co          , Co          , Rb^Vo       , Rb^Vo       , Rb          , Rb          , Rb          , Rb^Vo       , Rb^Vo       , Co          , Co          , Wwg         , Wwg         , Wwg         
Gs^Ft       , Gs^Ft       , Gs^Ft       , Gs^Ft       , Rb^Ft       , Rb^Ft       , Gs^Ft       , Gs^Ft       , Gs^Ft       , Rb^Ft       , Gs^Ft       , Rb^Ft       , Hh          , Hh          , Rb^Edpp     , Rb^Vhs      , Gs^Ft       , Rb          , Rb          , Gs^Ft       , Gs^Ft       , Ds          , Gs^Ft       , Rb^Ft       , Rb^Ft       , Gs^Ft       , Gs^Ft       , Hh          , Hh          , Wwg         , Wwg         , Wwg         , Wwg         , Co          , Co          , Rb^Vo       , Rb          , Rb^Vo       , Co          , Co          , Wwg         , Wwg         , Wwg         , Wwg         , Gs^Ft       
Gs^Ft       , Gs^Ft       , Ss^Vhs      , Rb^Ft       , Gs^Ft       , Gs^Ft       , Gs^Ft       , Gs^Ft       , Gs^Ft       , Ss^Vhs      , Ds          , Rb^Ft       , Gs^Ft       , Hh          , Hh          , Gs^Ft       , Gs^Ft       , Gs^Ft       , Gs^Ft       , Rb          , Rb          , Gs^Ft       , Gs^Ft       , Rb^Ft       , Gs^Ft       , Gs^Ft       , Rb^Vhs      , Gs^Ft       , Gs^Ft       , Hh          , Hh          , Wwg         , Wwg         , Wwg         , Wwg         , Co          , Rb          , Co          , Wwg         , Wwg         , Wwg         , Wwg         , Gs^Ft       , Gs^Ft       , Gs^Ft       
Ss          , Ss          , Ss^Bw|      , Ss          , Ss          , Gs^Ft       , Ss          , Gs^Ft       , Ss          , Ss          , Gs^Ft       , Ds^Bw|      , Ds          , Gs^Ft       , Gs^Ft       , Hh          , Gs^Ft       , Ds          , Gs^Ft       , Rb^Ft       , Gs^Ft       , Rb          , Rb          , Gs^Ft       , Rb^Ft       , Rb^Ft       , Gs^Ft       , Gs^Ft       , Gs^Ft       , Gs^Ft       , Gs^Ft       , Gs^Ft       , Gs^Ft       , Wwg         , Wwg         , Wwg         , Wwg^Bw|     , Wwg         , Wwg         , Wwg         , Gs^Ft       , Gs^Ft       , Gs^Ft       , Gs^Ft       , Gs^Ft       
Ss          , Gs^Ft       , Rb^Ft       , Gs^Ft       , Rb^Gvs      , Ss          , Rb^Ft       , Ss          , Rb^Ft       , Ss          , Ss^Bw/      , Ss^Vhs      , Ss          , Ds          , Gs^Ft       , Gs^Ft       , Gs^Ft       , Gs^Ft       , Rb^Ft       , Rb^Ft       , Gs^Ft       , Gs^Ft       , Gs^Ft       , Rb          , Rb          , Gs^Ft       , Gs^Ft       , Gs^Ft       , Rb^Ft       , Rb^Ft       , Rb^Ft       , Rb^Ft       , Rb^Ft       , Gs^Ft       , Gs^Ft       , Wwg         , Wwg^Bw|     , Wwg         , Gs^Ft       , Gs^Ft       , Gs^Ft       , Gs^Ft       , Gs^Ft       , Gs^Ft       , Gs^Ft       
Gs^Ft       , Gs^Ft       , Gs^Ft       , Rb^Ft       , Ss          , Rb^Ft       , Ss          , Rb^Ft       , Ss          , Rb^Ft       , Gs^Ft       , Ss          , Gs^Ft       , Ss          , Ss          , Gs^Ft       , Gs^Ft       , Gs^Ft       , Rb^Ft       , Rb^Ft       , Gs^Ft       , Rb^Ft       , Rb^Ft       , Gs^Ft       , Rb^Ft       , Rb          , Rb          , Rb^Ft       , Gs^Ft       , Gs^Ft       , Gs^Ft       , Rb^Ft       , Rb^Ft       , Gs^Ft       , Gs^Ft       , Gs^Ft       , Rb          , Gs^Ft       , Gs^Ft       , Gs^Ft       , Gs^Ft       , Rb^Vhs      , Gs^Ft       , Gs^Ft       , Gs^Ft       
Ss          , Ss          , Ss^Bw|      , Ss          , Ss          , Ss          , Ds          , Ss          , Gs^Ft       , Ss          , Ss          , Ss          , Gs^Ft       , Rb^Ft       , Gs^Ft       , Ss          , Ss          , Gs^Ft       , Gs^Ft       , Rb^Ft       , Gs^Ft       , Gs^Ft       , Rb^Ft       , Hh          , Hh          , Gs^Ft       , Gs^Ft       , Rb          , Rb          , Rb          , Rb          , Gs^Ft       , Gs^Ft       , Rb^Ft       , Gs^Ft       , Gs^Ft       , Rb          , Gs^Ft       , Gs^Ft       , Gs^Ft       , Gs^Ft       , Gs^Ft       , Gs^Ft       , Gs^Ft       , Gs^Ft       
Ss          , Ss          , Ss^Bw\      , Gs^Ft       , Gs^Ft       , Ss          , Gs^Ft       , Gs^Ft       , Ss          , Gs^Ft       , Rb^Ft       , Ss^Vhs      , Gs^Ft       , Rb^Ft       , Ss          , Gs^Ft       , Ss          , Ss          , Ss          , Ss^Vhs      , Rb^Ft       , Gs^Ft       , Gs^Ft       , Rb^Ft       , Hh          , Hh          , Rb^Ft       , Gs^Ft       , Gs^Ft       , Gs^Ft       , Gs^Ft       , Rb          , Rb          , Rb          , Rb          , Rb          , Rb          , Gs^Ft       , Gs^Ft       , Gs^Ft       , Gs^Ft       , Gs^Ft       , Gs^Ft       , Gs^Ft       , Gs^Ft       
Ss          , Ss          , Gs^Ft       , Ss^Vhs      , Ss^Bw\      , Ss          , Ss          , Rb^Ft       , Ss^Bw/      , Ss^Bw/      , Gs^Ft       , Ss          , Ss          , Ss          , Gs^Ft       , Ss          , Gs^Ft       , Ss          , Ss          , Ss          , Ss^Bw/      , Rb^Ft       , Sm          , Gs^Ft       , Gs^Ft       , Hh          , Rb^Ft       , Gs^Ft       , Rb^Ft       , Gs^Ft       , Rb^Vhs      , Gs^Ft       , Gs^Ft       , Gs^Ft       , Gs^Ft       , Gs^Ft       , Rb          , Gs^Ft       , Gs^Ft       , Gs^Ft       , Gs^Ft       , Gs^Ft       , Gs^Ft       , Gs^Ft       , Gs^Ft       
Ss          , Ss          , Ss          , Ss          , Gs^Ft       , Rb^Ft       , Sm          , Gs^Ft       , Gs^Ft       , Ss          , Ss          , Ss          , Gs^Ft       , Gs^Ft       , Gs^Ft       , Ss          , Ss          , Gs^Ft       , Gs^Ft       , Ss^Vhs      , Gs^Ft       , Ss          , Gs^Ft       , Sm          , Sm          , Gs^Ft       , Gs^Ft       , Rb^Ft       , Rb^Ft       , Gs^Ft       , Gs^Ft       , Gs^Ft       , Gs^Ft       , Gs^Ft       , Gs^Ft       , Gs^Ft       , Rb          , Gs^Ft       , Rb^Vhs      , Gs^Ft       , Gs^Ft       , Gs^Ft       , Gs^Ft       , Gs^Ft       , Gs^Ft       
Ss          , Ss          , Ss          , Gs^Ft       , Gs^Ft       , Rb^Ft       , Sm          , Gs^Ft       , Gs^Ft       , Gs^Ft       , Gs^Ft       , Ss          , Ss          , Ss          , Ss          , Ss          , Gs^Ft       , Ss^Bw/      , Ss          , Ss          , Gs^Ft       , Ss          , Ss          , Gs^Ft       , Gs^Ft       , Sm          , Gs^Ft       , Gs^Ft       , Gs^Ft       , Gs^Ft       , Gs^Ft       , Gs^Ft       , Gs^Ft       , Gs^Ft       , Gs^Ft       , Gs^Ft       , Rb          , Gs^Ft       , Gs^Ft       , Gs^Ft       , Gs^Ft       , Gs^Ft       , Gs^Ft       , Gs^Ft       , Gs^Ft       
